日期,货品ID,货品编码,货品名称,仓库名称,期初总量,期初良品,期初次品,入库总量,入库良品,入库次品,良品盘盈,次品盘盈,出库总量,良品销售发货,良品其他出库,次品出库,良品盘亏,次品盘亏,期末总量,期末良品,期末次品,采购在途,调拨在途,退仓调拨在途,调账出库总量,调账出库良品,调账出库次品,调整出库总量,调整出库良品,调整出库次品,调账入库总量,调入出库良品,调账入库次品,调整入库总量,调入出库良品,调整入库次品
2018-04-30,521783551638,XY521074093868,Graceland Fruit 蔓越莓切片果干 226.8克,菜鸟上海保税1号仓,259,258,1,0,0,0,0,0,0,0,0,0,0,0,259,258,1,0,0,0,0,0,0,0,0,0,0,0,0,0,0,0
2018-04-30,521786983343,XY521068155265,Graceland Fruit 整粒蔓越莓果干 1000克,菜鸟上海保税1号仓,34,34,0,0,0,0,0,0,3,3,0,0,0,0,31,31,0,0,0,0,0,0,0,0,0,0,0,0,0,0,0,0
2018-04-30,521795141212,XY521078390258,Graceland Fruit 整粒蔓越莓果干 226.8克,菜鸟上海保税1号仓,11967,495,11472,0,0,0,0,0,8,8,0,0,0,0,11959,487,11472,0,0,0,0,0,0,0,0,0,0,0,0,0,0,0
2018-04-30,521798656939,XY521074725008,Graceland Fruit 蔓越莓切片果干 1000克,菜鸟上海保税1号仓,166,166,0,0,0,0,0,0,0,0,0,0,0,0,166,166,0,0,0,0,0,0,0,0,0,0,0,0,0,0,0,0
2018-04-30,521798712600,XY521078064529,Graceland Fruit 酸樱桃果干 141.7克,菜鸟上海保税1号仓,392,392,0,0,0,0,0,0,0,0,0,0,0,0,392,392,0,0,0,0,0,0,0,0,0,0,0,0,0,0,0,0
2018-04-30,521798716403,XY521077912497,Graceland Fruit 蓝莓果干 1000克,菜鸟上海保税1号仓,55,55,0,0,0,0,0,0,0,0,0,0,0,0,55,55,0,0,0,0,0,0,0,0,0,0,0,0,0,0,0,0
2018-04-30,521799186703,XY521073901132,Graceland Fruit 蓝莓果干 141.7克,菜鸟上海保税1号仓,5296,993,4303,0,0,0,0,0,12,12,0,0,0,0,5284,981,4303,0,0,0,0,0,0,0,0,0,0,0,0,0,0,0
2018-04-30,521799426484,XY521074249153,Graceland Fruit 酸樱桃果干 1000克,菜鸟上海保税1号仓,105,105,0,0,0,0,0,0,0,0,0,0,0,0,105,105,0,0,0,0,0,0,0,0,0,0,0,0,0,0,0,0
2018-04-30,542151364809,708390000210,GracelandFruit莓果橙皮 混合果干 454克,菜鸟上海保税1号仓,40,40,0,0,0,0,0,0,1,1,0,0,0,0,39,39,0,0,0,0,0,0,0,0,0,0,0,0,0,0,0,0
2018-04-30,542151596151,708390000227,GracelandFruit芒果莓果 混合果干 454克,菜鸟上海保税1号仓,16,16,0,0,0,0,0,0,1,1,0,0,0,0,15,15,0,0,0,0,0,0,0,0,0,0,0,0,0,0,0,0
2018-04-30,562082510339,8802534778019,Graceland Fruit整粒蔓越莓黑巧克力,菜鸟上海保税1号仓,1601,1601,0,0,0,0,0,0,1,1,0,0,0,0,1600,1600,0,0,0,0,0,0,0,0,0,0,0,0,0,0,0,0
2018-04-30,562106910483,8802534778002,Graceland Fruit蓝莓黑巧克力,菜鸟上海保税1号仓,1204,1204,0,0,0,0,0,0,0,0,0,0,0,0,1204,1204,0,0,0,0,0,0,0,0,0,0,0,0,0,0,0,0
2018-04-30,565284028009,X708390000326,美国果瑞氏无糖蔓越莓果干113.4克,菜鸟上海保税1号仓,256,256,0,0,0,0,0,0,0,0,0,0,0,0,256,256,0,0,0,0,0,0,0,0,0,0,0,0,0,0,0,0
2018-04-30,521783799351,XY521067771349,Graceland Fruit 整粒蔓越莓果干 40克,菜鸟宁波保税1号仓,6,0,6,0,0,0,0,0,0,0,0,0,0,0,6,0,6,0,0,0,0,0,0,0,0,0,0,0,0,0,0,0
2018-04-30,521795141212,XY521078390258,Graceland Fruit 整粒蔓越莓果干 226.8克,菜鸟宁波保税1号仓,1,0,1,0,0,0,0,0,0,0,0,0,0,0,1,0,1,0,0,0,0,0,0,0,0,0,0,0,0,0,0,0
2018-04-30,521799186703,XY521073901132,Graceland Fruit 蓝莓果干 141.7克,菜鸟宁波保税1号仓,1,1,0,0,0,0,0,0,0,0,0,0,0,0,1,1,0,0,0,0,0,0,0,0,0,0,0,0,0,0,0,0
2018-04-30,542151364809,708390000210,GracelandFruit莓果橙皮 混合果干 454克,菜鸟宁波保税1号仓,278,0,278,0,0,0,0,0,0,0,0,0,0,0,278,0,278,0,0,0,0,0,0,0,0,0,0,0,0,0,0,0
2018-04-30,542151596151,708390000227,GracelandFruit芒果莓果 混合果干 454克,菜鸟宁波保税1号仓,1,0,1,0,0,0,0,0,0,0,0,0,0,0,1,0,1,0,0,0,0,0,0,0,0,0,0,0,0,0,0,0
2018-04-30,542176430821,708390000203,GracelandFruit全美苹果 混合果干 454克,菜鸟宁波保税1号仓,354,0,354,0,0,0,0,0,0,0,0,0,0,0,354,0,354,0,0,0,0,0,0,0,0,0,0,0,0,0,0,0
2018-04-29,521783551638,XY521074093868,Graceland Fruit 蔓越莓切片果干 226.8克,菜鸟上海保税1号仓,264,263,1,0,0,0,0,0,5,5,0,0,0,0,259,258,1,0,0,0,0,0,0,0,0,0,0,0,0,0,0,0
2018-04-29,521786983343,XY521068155265,Graceland Fruit 整粒蔓越莓果干 1000克,菜鸟上海保税1号仓,36,36,0,0,0,0,0,0,2,2,0,0,0,0,34,34,0,0,0,0,0,0,0,0,0,0,0,0,0,0,0,0
2018-04-29,521795141212,XY521078390258,Graceland Fruit 整粒蔓越莓果干 226.8克,菜鸟上海保税1号仓,11971,499,11472,0,0,0,0,0,4,4,0,0,0,0,11967,495,11472,0,0,0,0,0,0,0,0,0,0,0,0,0,0,0
2018-04-29,521798656939,XY521074725008,Graceland Fruit 蔓越莓切片果干 1000克,菜鸟上海保税1号仓,166,166,0,0,0,0,0,0,0,0,0,0,0,0,166,166,0,0,0,0,0,0,0,0,0,0,0,0,0,0,0,0
2018-04-29,521798712600,XY521078064529,Graceland Fruit 酸樱桃果干 141.7克,菜鸟上海保税1号仓,392,392,0,0,0,0,0,0,0,0,0,0,0,0,392,392,0,0,0,0,0,0,0,0,0,0,0,0,0,0,0,0
2018-04-29,521798716403,XY521077912497,Graceland Fruit 蓝莓果干 1000克,菜鸟上海保税1号仓,55,55,0,0,0,0,0,0,0,0,0,0,0,0,55,55,0,0,0,0,0,0,0,0,0,0,0,0,0,0,0,0
2018-04-29,521799186703,XY521073901132,Graceland Fruit 蓝莓果干 141.7克,菜鸟上海保税1号仓,5298,995,4303,0,0,0,0,0,2,2,0,0,0,0,5296,993,4303,0,0,0,0,0,0,0,0,0,0,0,0,0,0,0
2018-04-29,521799426484,XY521074249153,Graceland Fruit 酸樱桃果干 1000克,菜鸟上海保税1号仓,105,105,0,0,0,0,0,0,0,0,0,0,0,0,105,105,0,0,0,0,0,0,0,0,0,0,0,0,0,0,0,0
2018-04-29,542151364809,708390000210,GracelandFruit莓果橙皮 混合果干 454克,菜鸟上海保税1号仓,40,40,0,0,0,0,0,0,0,0,0,0,0,0,40,40,0,0,0,0,0,0,0,0,0,0,0,0,0,0,0,0
2018-04-29,542151596151,708390000227,GracelandFruit芒果莓果 混合果干 454克,菜鸟上海保税1号仓,16,16,0,0,0,0,0,0,0,0,0,0,0,0,16,16,0,0,0,0,0,0,0,0,0,0,0,0,0,0,0,0
2018-04-29,562082510339,8802534778019,Graceland Fruit整粒蔓越莓黑巧克力,菜鸟上海保税1号仓,1604,1604,0,0,0,0,0,0,3,3,0,0,0,0,1601,1601,0,0,0,0,0,0,0,0,0,0,0,0,0,0,0,0
2018-04-29,562106910483,8802534778002,Graceland Fruit蓝莓黑巧克力,菜鸟上海保税1号仓,1209,1209,0,0,0,0,0,0,5,5,0,0,0,0,1204,1204,0,0,0,0,0,0,0,0,0,0,0,0,0,0,0,0
2018-04-29,565284028009,X708390000326,美国果瑞氏无糖蔓越莓果干113.4克,菜鸟上海保税1号仓,256,256,0,0,0,0,0,0,0,0,0,0,0,0,256,256,0,0,0,0,0,0,0,0,0,0,0,0,0,0,0,0
2018-04-29,521783799351,XY521067771349,Graceland Fruit 整粒蔓越莓果干 40克,菜鸟宁波保税1号仓,6,0,6,0,0,0,0,0,0,0,0,0,0,0,6,0,6,0,0,0,0,0,0,0,0,0,0,0,0,0,0,0
2018-04-29,521795141212,XY521078390258,Graceland Fruit 整粒蔓越莓果干 226.8克,菜鸟宁波保税1号仓,1,0,1,0,0,0,0,0,0,0,0,0,0,0,1,0,1,0,0,0,0,0,0,0,0,0,0,0,0,0,0,0
2018-04-29,521799186703,XY521073901132,Graceland Fruit 蓝莓果干 141.7克,菜鸟宁波保税1号仓,1,1,0,0,0,0,0,0,0,0,0,0,0,0,1,1,0,0,0,0,0,0,0,0,0,0,0,0,0,0,0,0
2018-04-29,542151364809,708390000210,GracelandFruit莓果橙皮 混合果干 454克,菜鸟宁波保税1号仓,278,0,278,0,0,0,0,0,0,0,0,0,0,0,278,0,278,0,0,0,0,0,0,0,0,0,0,0,0,0,0,0
2018-04-29,542151596151,708390000227,GracelandFruit芒果莓果 混合果干 454克,菜鸟宁波保税1号仓,1,0,1,0,0,0,0,0,0,0,0,0,0,0,1,0,1,0,0,0,0,0,0,0,0,0,0,0,0,0,0,0
2018-04-29,542176430821,708390000203,GracelandFruit全美苹果 混合果干 454克,菜鸟宁波保税1号仓,354,0,354,0,0,0,0,0,0,0,0,0,0,0,354,0,354,0,0,0,0,0,0,0,0,0,0,0,0,0,0,0
2018-04-28,521783551638,XY521074093868,Graceland Fruit 蔓越莓切片果干 226.8克,菜鸟上海保税1号仓,267,266,1,0,0,0,0,0,3,3,0,0,0,0,264,263,1,0,0,0,0,0,0,0,0,0,0,0,0,0,0,0
2018-04-28,521786983343,XY521068155265,Graceland Fruit 整粒蔓越莓果干 1000克,菜鸟上海保税1号仓,37,37,0,0,0,0,0,0,1,1,0,0,0,0,36,36,0,0,0,0,0,0,0,0,0,0,0,0,0,0,0,0
2018-04-28,521795141212,XY521078390258,Graceland Fruit 整粒蔓越莓果干 226.8克,菜鸟上海保税1号仓,11973,501,11472,0,0,0,0,0,2,2,0,0,0,0,11971,499,11472,0,0,0,0,0,0,0,0,0,0,0,0,0,0,0
2018-04-28,521798656939,XY521074725008,Graceland Fruit 蔓越莓切片果干 1000克,菜鸟上海保税1号仓,168,168,0,0,0,0,0,0,2,2,0,0,0,0,166,166,0,0,0,0,0,0,0,0,0,0,0,0,0,0,0,0
2018-04-28,521798712600,XY521078064529,Graceland Fruit 酸樱桃果干 141.7克,菜鸟上海保税1号仓,392,392,0,0,0,0,0,0,0,0,0,0,0,0,392,392,0,0,0,0,0,0,0,0,0,0,0,0,0,0,0,0
2018-04-28,521798716403,XY521077912497,Graceland Fruit 蓝莓果干 1000克,菜鸟上海保税1号仓,58,58,0,0,0,0,0,0,3,3,0,0,0,0,55,55,0,0,0,0,0,0,0,0,0,0,0,0,0,0,0,0
2018-04-28,521799186703,XY521073901132,Graceland Fruit 蓝莓果干 141.7克,菜鸟上海保税1号仓,5305,1002,4303,0,0,0,0,0,7,7,0,0,0,0,5298,995,4303,0,0,0,0,0,0,0,0,0,0,0,0,0,0,0
2018-04-28,521799426484,XY521074249153,Graceland Fruit 酸樱桃果干 1000克,菜鸟上海保税1号仓,106,106,0,0,0,0,0,0,1,1,0,0,0,0,105,105,0,0,0,0,0,0,0,0,0,0,0,0,0,0,0,0
2018-04-28,542151364809,708390000210,GracelandFruit莓果橙皮 混合果干 454克,菜鸟上海保税1号仓,40,40,0,0,0,0,0,0,0,0,0,0,0,0,40,40,0,0,0,0,0,0,0,0,0,0,0,0,0,0,0,0
2018-04-28,542151596151,708390000227,GracelandFruit芒果莓果 混合果干 454克,菜鸟上海保税1号仓,16,16,0,0,0,0,0,0,0,0,0,0,0,0,16,16,0,0,0,0,0,0,0,0,0,0,0,0,0,0,0,0
2018-04-28,562082510339,8802534778019,Graceland Fruit整粒蔓越莓黑巧克力,菜鸟上海保税1号仓,1608,1608,0,0,0,0,0,0,4,4,0,0,0,0,1604,1604,0,0,0,0,0,0,0,0,0,0,0,0,0,0,0,0
2018-04-28,562106910483,8802534778002,Graceland Fruit蓝莓黑巧克力,菜鸟上海保税1号仓,1214,1214,0,0,0,0,0,0,5,5,0,0,0,0,1209,1209,0,0,0,0,0,0,0,0,0,0,0,0,0,0,0,0
2018-04-28,565284028009,X708390000326,美国果瑞氏无糖蔓越莓果干113.4克,菜鸟上海保税1号仓,256,256,0,0,0,0,0,0,0,0,0,0,0,0,256,256,0,0,0,0,0,0,0,0,0,0,0,0,0,0,0,0
2018-04-28,521783799351,XY521067771349,Graceland Fruit 整粒蔓越莓果干 40克,菜鸟宁波保税1号仓,6,0,6,0,0,0,0,0,0,0,0,0,0,0,6,0,6,0,0,0,0,0,0,0,0,0,0,0,0,0,0,0
2018-04-28,521795141212,XY521078390258,Graceland Fruit 整粒蔓越莓果干 226.8克,菜鸟宁波保税1号仓,1,0,1,0,0,0,0,0,0,0,0,0,0,0,1,0,1,0,0,0,0,0,0,0,0,0,0,0,0,0,0,0
2018-04-28,521799186703,XY521073901132,Graceland Fruit 蓝莓果干 141.7克,菜鸟宁波保税1号仓,1,1,0,0,0,0,0,0,0,0,0,0,0,0,1,1,0,0,0,0,0,0,0,0,0,0,0,0,0,0,0,0
2018-04-28,542151364809,708390000210,GracelandFruit莓果橙皮 混合果干 454克,菜鸟宁波保税1号仓,278,0,278,0,0,0,0,0,0,0,0,0,0,0,278,0,278,0,0,0,0,0,0,0,0,0,0,0,0,0,0,0
2018-04-28,542151596151,708390000227,GracelandFruit芒果莓果 混合果干 454克,菜鸟宁波保税1号仓,1,0,1,0,0,0,0,0,0,0,0,0,0,0,1,0,1,0,0,0,0,0,0,0,0,0,0,0,0,0,0,0
2018-04-28,542176430821,708390000203,GracelandFruit全美苹果 混合果干 454克,菜鸟宁波保税1号仓,354,0,354,0,0,0,0,0,0,0,0,0,0,0,354,0,354,0,0,0,0,0,0,0,0,0,0,0,0,0,0,0
2018-04-27,521783551638,XY521074093868,Graceland Fruit 蔓越莓切片果干 226.8克,菜鸟上海保税1号仓,275,274,1,0,0,0,0,0,8,8,0,0,0,0,267,266,1,0,0,0,0,0,0,0,0,0,0,0,0,0,0,0
2018-04-27,521786983343,XY521068155265,Graceland Fruit 整粒蔓越莓果干 1000克,菜鸟上海保税1号仓,39,39,0,0,0,0,0,0,2,2,0,0,0,0,37,37,0,0,0,0,0,0,0,0,0,0,0,0,0,0,0,0
2018-04-27,521795141212,XY521078390258,Graceland Fruit 整粒蔓越莓果干 226.8克,菜鸟上海保税1号仓,11473,1,11472,500,500,0,0,0,0,0,0,0,0,0,11973,501,11472,0,0,0,0,0,0,0,0,0,0,0,0,0,0,0
2018-04-27,521798656939,XY521074725008,Graceland Fruit 蔓越莓切片果干 1000克,菜鸟上海保税1号仓,171,171,0,0,0,0,0,0,3,3,0,0,0,0,168,168,0,0,0,0,0,0,0,0,0,0,0,0,0,0,0,0
2018-04-27,521798712600,XY521078064529,Graceland Fruit 酸樱桃果干 141.7克,菜鸟上海保税1号仓,396,396,0,0,0,0,0,0,4,4,0,0,0,0,392,392,0,0,0,0,0,0,0,0,0,0,0,0,0,0,0,0
2018-04-27,521798716403,XY521077912497,Graceland Fruit 蓝莓果干 1000克,菜鸟上海保税1号仓,61,61,0,0,0,0,0,0,3,3,0,0,0,0,58,58,0,0,0,0,0,0,0,0,0,0,0,0,0,0,0,0
2018-04-27,521799186703,XY521073901132,Graceland Fruit 蓝莓果干 141.7克,菜鸟上海保税1号仓,4305,2,4303,1000,1000,0,0,0,0,0,0,0,0,0,5305,1002,4303,0,0,0,0,0,0,0,0,0,0,0,0,0,0,0
2018-04-27,521799426484,XY521074249153,Graceland Fruit 酸樱桃果干 1000克,菜鸟上海保税1号仓,107,107,0,0,0,0,0,0,1,1,0,0,0,0,106,106,0,0,0,0,0,0,0,0,0,0,0,0,0,0,0,0
2018-04-27,542151364809,708390000210,GracelandFruit莓果橙皮 混合果干 454克,菜鸟上海保税1号仓,40,40,0,0,0,0,0,0,0,0,0,0,0,0,40,40,0,0,0,0,0,0,0,0,0,0,0,0,0,0,0,0
2018-04-27,542151596151,708390000227,GracelandFruit芒果莓果 混合果干 454克,菜鸟上海保税1号仓,16,16,0,0,0,0,0,0,0,0,0,0,0,0,16,16,0,0,0,0,0,0,0,0,0,0,0,0,0,0,0,0
2018-04-27,562082510339,8802534778019,Graceland Fruit整粒蔓越莓黑巧克力,菜鸟上海保税1号仓,1611,1611,0,0,0,0,0,0,3,3,0,0,0,0,1608,1608,0,0,0,0,0,0,0,0,0,0,0,0,0,0,0,0
2018-04-27,562106910483,8802534778002,Graceland Fruit蓝莓黑巧克力,菜鸟上海保税1号仓,1219,1219,0,0,0,0,0,0,5,5,0,0,0,0,1214,1214,0,0,0,0,0,0,0,0,0,0,0,0,0,0,0,0
2018-04-27,565284028009,X708390000326,美国果瑞氏无糖蔓越莓果干113.4克,菜鸟上海保税1号仓,257,257,0,0,0,0,0,0,1,1,0,0,0,0,256,256,0,0,0,0,0,0,0,0,0,0,0,0,0,0,0,0
2018-04-27,521783799351,XY521067771349,Graceland Fruit 整粒蔓越莓果干 40克,菜鸟宁波保税1号仓,6,0,6,0,0,0,0,0,0,0,0,0,0,0,6,0,6,0,0,0,0,0,0,0,0,0,0,0,0,0,0,0
2018-04-27,521795141212,XY521078390258,Graceland Fruit 整粒蔓越莓果干 226.8克,菜鸟宁波保税1号仓,1,0,1,0,0,0,0,0,0,0,0,0,0,0,1,0,1,0,0,0,0,0,0,0,0,0,0,0,0,0,0,0
2018-04-27,521799186703,XY521073901132,Graceland Fruit 蓝莓果干 141.7克,菜鸟宁波保税1号仓,1,1,0,0,0,0,0,0,0,0,0,0,0,0,1,1,0,0,0,0,0,0,0,0,0,0,0,0,0,0,0,0
2018-04-27,542151364809,708390000210,GracelandFruit莓果橙皮 混合果干 454克,菜鸟宁波保税1号仓,278,0,278,0,0,0,0,0,0,0,0,0,0,0,278,0,278,0,0,0,0,0,0,0,0,0,0,0,0,0,0,0
2018-04-27,542151596151,708390000227,GracelandFruit芒果莓果 混合果干 454克,菜鸟宁波保税1号仓,1,0,1,0,0,0,0,0,0,0,0,0,0,0,1,0,1,0,0,0,0,0,0,0,0,0,0,0,0,0,0,0
2018-04-27,542176430821,708390000203,GracelandFruit全美苹果 混合果干 454克,菜鸟宁波保税1号仓,354,0,354,0,0,0,0,0,0,0,0,0,0,0,354,0,354,0,0,0,0,0,0,0,0,0,0,0,0,0,0,0
2018-04-26,521783551638,XY521074093868,Graceland Fruit 蔓越莓切片果干 226.8克,菜鸟上海保税1号仓,280,280,0,1,0,1,0,0,6,5,1,0,0,0,275,274,1,0,0,0,0,0,0,1,1,0,0,0,0,1,0,1
2018-04-26,521786983343,XY521068155265,Graceland Fruit 整粒蔓越莓果干 1000克,菜鸟上海保税1号仓,43,43,0,0,0,0,0,0,4,4,0,0,0,0,39,39,0,0,0,0,0,0,0,0,0,0,0,0,0,0,0,0
2018-04-26,521795141212,XY521078390258,Graceland Fruit 整粒蔓越莓果干 226.8克,菜鸟上海保税1号仓,11507,35,11472,2,1,1,0,0,36,34,1,1,0,0,11473,1,11472,500,0,0,0,0,0,2,1,1,0,0,0,2,1,1
2018-04-26,521798656939,XY521074725008,Graceland Fruit 蔓越莓切片果干 1000克,菜鸟上海保税1号仓,172,172,0,0,0,0,0,0,1,1,0,0,0,0,171,171,0,0,0,0,0,0,0,0,0,0,0,0,0,0,0,0
2018-04-26,521798712600,XY521078064529,Graceland Fruit 酸樱桃果干 141.7克,菜鸟上海保税1号仓,410,410,0,0,0,0,0,0,14,14,0,0,0,0,396,396,0,0,0,0,0,0,0,0,0,0,0,0,0,0,0,0
2018-04-26,521798716403,XY521077912497,Graceland Fruit 蓝莓果干 1000克,菜鸟上海保税1号仓,61,61,0,0,0,0,0,0,0,0,0,0,0,0,61,61,0,0,0,0,0,0,0,0,0,0,0,0,0,0,0,0
2018-04-26,521799186703,XY521073901132,Graceland Fruit 蓝莓果干 141.7克,菜鸟上海保税1号仓,4384,81,4303,0,0,0,0,0,79,79,0,0,0,0,4305,2,4303,1000,0,0,0,0,0,0,0,0,0,0,0,0,0,0
2018-04-26,521799426484,XY521074249153,Graceland Fruit 酸樱桃果干 1000克,菜鸟上海保税1号仓,108,108,0,0,0,0,0,0,1,1,0,0,0,0,107,107,0,0,0,0,0,0,0,0,0,0,0,0,0,0,0,0
2018-04-26,542151364809,708390000210,GracelandFruit莓果橙皮 混合果干 454克,菜鸟上海保税1号仓,41,41,0,0,0,0,0,0,1,1,0,0,0,0,40,40,0,0,0,0,0,0,0,0,0,0,0,0,0,0,0,0
2018-04-26,542151596151,708390000227,GracelandFruit芒果莓果 混合果干 454克,菜鸟上海保税1号仓,17,17,0,0,0,0,0,0,1,1,0,0,0,0,16,16,0,0,0,0,0,0,0,0,0,0,0,0,0,0,0,0
2018-04-26,562082510339,8802534778019,Graceland Fruit整粒蔓越莓黑巧克力,菜鸟上海保税1号仓,1636,1636,0,0,0,0,0,0,25,25,0,0,0,0,1611,1611,0,0,0,0,0,0,0,0,0,0,0,0,0,0,0,0
2018-04-26,562106910483,8802534778002,Graceland Fruit蓝莓黑巧克力,菜鸟上海保税1号仓,1247,1247,0,0,0,0,0,0,28,28,0,0,0,0,1219,1219,0,0,0,0,0,0,0,0,0,0,0,0,0,0,0,0
2018-04-26,565284028009,X708390000326,美国果瑞氏无糖蔓越莓果干113.4克,菜鸟上海保税1号仓,263,263,0,0,0,0,0,0,6,6,0,0,0,0,257,257,0,0,0,0,0,0,0,0,0,0,0,0,0,0,0,0
2018-04-26,521783799351,XY521067771349,Graceland Fruit 整粒蔓越莓果干 40克,菜鸟宁波保税1号仓,6,0,6,0,0,0,0,0,0,0,0,0,0,0,6,0,6,0,0,0,0,0,0,0,0,0,0,0,0,0,0,0
2018-04-26,521795141212,XY521078390258,Graceland Fruit 整粒蔓越莓果干 226.8克,菜鸟宁波保税1号仓,1,0,1,0,0,0,0,0,0,0,0,0,0,0,1,0,1,0,0,0,0,0,0,0,0,0,0,0,0,0,0,0
2018-04-26,521799186703,XY521073901132,Graceland Fruit 蓝莓果干 141.7克,菜鸟宁波保税1号仓,3,3,0,0,0,0,0,0,2,2,0,0,0,0,1,1,0,0,0,0,0,0,0,0,0,0,0,0,0,0,0,0
2018-04-26,542151364809,708390000210,GracelandFruit莓果橙皮 混合果干 454克,菜鸟宁波保税1号仓,278,0,278,0,0,0,0,0,0,0,0,0,0,0,278,0,278,0,0,0,0,0,0,0,0,0,0,0,0,0,0,0
2018-04-26,542151596151,708390000227,GracelandFruit芒果莓果 混合果干 454克,菜鸟宁波保税1号仓,1,0,1,0,0,0,0,0,0,0,0,0,0,0,1,0,1,0,0,0,0,0,0,0,0,0,0,0,0,0,0,0
2018-04-26,542176430821,708390000203,GracelandFruit全美苹果 混合果干 454克,菜鸟宁波保税1号仓,354,0,354,0,0,0,0,0,0,0,0,0,0,0,354,0,354,0,0,0,0,0,0,0,0,0,0,0,0,0,0,0
2018-04-25,521783551638,XY521074093868,Graceland Fruit 蔓越莓切片果干 226.8克,菜鸟上海保税1号仓,286,286,0,0,0,0,0,0,6,6,0,0,0,0,280,280,0,0,0,0,0,0,0,0,0,0,0,0,0,0,0,0
2018-04-25,521786983343,XY521068155265,Graceland Fruit 整粒蔓越莓果干 1000克,菜鸟上海保税1号仓,53,53,0,0,0,0,0,0,10,10,0,0,0,0,43,43,0,0,0,0,0,0,0,0,0,0,0,0,0,0,0,0
2018-04-25,521795141212,XY521078390258,Graceland Fruit 整粒蔓越莓果干 226.8克,菜鸟上海保税1号仓,11569,97,11472,0,0,0,0,0,62,62,0,0,0,0,11507,35,11472,0,0,0,0,0,0,0,0,0,0,0,0,0,0,0
2018-04-25,521798656939,XY521074725008,Graceland Fruit 蔓越莓切片果干 1000克,菜鸟上海保税1号仓,177,177,0,0,0,0,0,0,5,5,0,0,0,0,172,172,0,0,0,0,0,0,0,0,0,0,0,0,0,0,0,0
2018-04-25,521798712600,XY521078064529,Graceland Fruit 酸樱桃果干 141.7克,菜鸟上海保税1号仓,448,448,0,0,0,0,0,0,38,38,0,0,0,0,410,410,0,0,0,0,0,0,0,0,0,0,0,0,0,0,0,0
2018-04-25,521798716403,XY521077912497,Graceland Fruit 蓝莓果干 1000克,菜鸟上海保税1号仓,63,63,0,0,0,0,0,0,2,2,0,0,0,0,61,61,0,0,0,0,0,0,0,0,0,0,0,0,0,0,0,0
2018-04-25,521799186703,XY521073901132,Graceland Fruit 蓝莓果干 141.7克,菜鸟上海保税1号仓,4502,199,4303,0,0,0,0,0,118,118,0,0,0,0,4384,81,4303,0,0,0,0,0,0,0,0,0,0,0,0,0,0,0
2018-04-25,521799426484,XY521074249153,Graceland Fruit 酸樱桃果干 1000克,菜鸟上海保税1号仓,109,109,0,0,0,0,0,0,1,1,0,0,0,0,108,108,0,0,0,0,0,0,0,0,0,0,0,0,0,0,0,0
2018-04-25,542151364809,708390000210,GracelandFruit莓果橙皮 混合果干 454克,菜鸟上海保税1号仓,41,41,0,0,0,0,0,0,0,0,0,0,0,0,41,41,0,0,0,0,0,0,0,0,0,0,0,0,0,0,0,0
2018-04-25,542151596151,708390000227,GracelandFruit芒果莓果 混合果干 454克,菜鸟上海保税1号仓,18,18,0,0,0,0,0,0,1,1,0,0,0,0,17,17,0,0,0,0,0,0,0,0,0,0,0,0,0,0,0,0
2018-04-25,562082510339,8802534778019,Graceland Fruit整粒蔓越莓黑巧克力,菜鸟上海保税1号仓,1685,1685,0,0,0,0,0,0,49,49,0,0,0,0,1636,1636,0,0,0,0,0,0,0,0,0,0,0,0,0,0,0,0
2018-04-25,562106910483,8802534778002,Graceland Fruit蓝莓黑巧克力,菜鸟上海保税1号仓,1307,1307,0,0,0,0,0,0,60,60,0,0,0,0,1247,1247,0,0,0,0,0,0,0,0,0,0,0,0,0,0,0,0
2018-04-25,565284028009,X708390000326,美国果瑞氏无糖蔓越莓果干113.4克,菜鸟上海保税1号仓,284,284,0,0,0,0,0,0,21,21,0,0,0,0,263,263,0,0,0,0,0,0,0,0,0,0,0,0,0,0,0,0
2018-04-25,521783799351,XY521067771349,Graceland Fruit 整粒蔓越莓果干 40克,菜鸟宁波保税1号仓,6,0,6,0,0,0,0,0,0,0,0,0,0,0,6,0,6,0,0,0,0,0,0,0,0,0,0,0,0,0,0,0
2018-04-25,521795141212,XY521078390258,Graceland Fruit 整粒蔓越莓果干 226.8克,菜鸟宁波保税1号仓,1,0,1,0,0,0,0,0,0,0,0,0,0,0,1,0,1,0,0,0,0,0,0,0,0,0,0,0,0,0,0,0
2018-04-25,521799186703,XY521073901132,Graceland Fruit 蓝莓果干 141.7克,菜鸟宁波保税1号仓,3,3,0,0,0,0,0,0,0,0,0,0,0,0,3,3,0,0,0,0,0,0,0,0,0,0,0,0,0,0,0,0
2018-04-25,542151364809,708390000210,GracelandFruit莓果橙皮 混合果干 454克,菜鸟宁波保税1号仓,278,0,278,0,0,0,0,0,0,0,0,0,0,0,278,0,278,0,0,0,0,0,0,0,0,0,0,0,0,0,0,0
2018-04-25,542151596151,708390000227,GracelandFruit芒果莓果 混合果干 454克,菜鸟宁波保税1号仓,1,0,1,0,0,0,0,0,0,0,0,0,0,0,1,0,1,0,0,0,0,0,0,0,0,0,0,0,0,0,0,0
2018-04-25,542176430821,708390000203,GracelandFruit全美苹果 混合果干 454克,菜鸟宁波保税1号仓,354,0,354,0,0,0,0,0,0,0,0,0,0,0,354,0,354,0,0,0,0,0,0,0,0,0,0,0,0,0,0,0
2018-04-24,521783551638,XY521074093868,Graceland Fruit 蔓越莓切片果干 226.8克,菜鸟上海保税1号仓,300,300,0,0,0,0,0,0,14,14,0,0,0,0,286,286,0,0,0,0,0,0,0,0,0,0,0,0,0,0,0,0
2018-04-24,521786983343,XY521068155265,Graceland Fruit 整粒蔓越莓果干 1000克,菜鸟上海保税1号仓,59,59,0,0,0,0,0,0,6,6,0,0,0,0,53,53,0,0,0,0,0,0,0,0,0,0,0,0,0,0,0,0
2018-04-24,521795141212,XY521078390258,Graceland Fruit 整粒蔓越莓果干 226.8克,菜鸟上海保税1号仓,11759,287,11472,0,0,0,0,0,190,190,0,0,0,0,11569,97,11472,0,0,0,0,0,0,0,0,0,0,0,0,0,0,0
2018-04-24,521798656939,XY521074725008,Graceland Fruit 蔓越莓切片果干 1000克,菜鸟上海保税1号仓,191,191,0,0,0,0,0,0,14,14,0,0,0,0,177,177,0,0,0,0,0,0,0,0,0,0,0,0,0,0,0,0
2018-04-24,521798712600,XY521078064529,Graceland Fruit 酸樱桃果干 141.7克,菜鸟上海保税1号仓,496,496,0,0,0,0,0,0,48,48,0,0,0,0,448,448,0,0,0,0,0,0,0,0,0,0,0,0,0,0,0,0
2018-04-24,521798716403,XY521077912497,Graceland Fruit 蓝莓果干 1000克,菜鸟上海保税1号仓,68,68,0,0,0,0,0,0,5,5,0,0,0,0,63,63,0,0,0,0,0,0,0,0,0,0,0,0,0,0,0,0
2018-04-24,521799186703,XY521073901132,Graceland Fruit 蓝莓果干 141.7克,菜鸟上海保税1号仓,4785,482,4303,0,0,0,0,0,283,283,0,0,0,0,4502,199,4303,0,0,0,0,0,0,0,0,0,0,0,0,0,0,0
2018-04-24,521799426484,XY521074249153,Graceland Fruit 酸樱桃果干 1000克,菜鸟上海保税1号仓,117,117,0,0,0,0,0,0,8,8,0,0,0,0,109,109,0,0,0,0,0,0,0,0,0,0,0,0,0,0,0,0
2018-04-24,542151364809,708390000210,GracelandFruit莓果橙皮 混合果干 454克,菜鸟上海保税1号仓,42,42,0,0,0,0,0,0,1,1,0,0,0,0,41,41,0,0,0,0,0,0,0,0,0,0,0,0,0,0,0,0
2018-04-24,542151596151,708390000227,GracelandFruit芒果莓果 混合果干 454克,菜鸟上海保税1号仓,19,19,0,0,0,0,0,0,1,1,0,0,0,0,18,18,0,0,0,0,0,0,0,0,0,0,0,0,0,0,0,0
2018-04-24,562082510339,8802534778019,Graceland Fruit整粒蔓越莓黑巧克力,菜鸟上海保税1号仓,1770,1770,0,0,0,0,0,0,85,85,0,0,0,0,1685,1685,0,0,0,0,0,0,0,0,0,0,0,0,0,0,0,0
2018-04-24,562106910483,8802534778002,Graceland Fruit蓝莓黑巧克力,菜鸟上海保税1号仓,1400,1400,0,0,0,0,0,0,93,93,0,0,0,0,1307,1307,0,0,0,0,0,0,0,0,0,0,0,0,0,0,0,0
2018-04-24,565284028009,X708390000326,美国果瑞氏无糖蔓越莓果干113.4克,菜鸟上海保税1号仓,300,300,0,0,0,0,0,0,16,16,0,0,0,0,284,284,0,0,0,0,0,0,0,0,0,0,0,0,0,0,0,0
2018-04-24,521783799351,XY521067771349,Graceland Fruit 整粒蔓越莓果干 40克,菜鸟宁波保税1号仓,6,0,6,0,0,0,0,0,0,0,0,0,0,0,6,0,6,0,0,0,0,0,0,0,0,0,0,0,0,0,0,0
2018-04-24,521795141212,XY521078390258,Graceland Fruit 整粒蔓越莓果干 226.8克,菜鸟宁波保税1号仓,1,0,1,0,0,0,0,0,0,0,0,0,0,0,1,0,1,0,0,0,0,0,0,0,0,0,0,0,0,0,0,0
2018-04-24,521799186703,XY521073901132,Graceland Fruit 蓝莓果干 141.7克,菜鸟宁波保税1号仓,3,3,0,0,0,0,0,0,0,0,0,0,0,0,3,3,0,0,0,0,0,0,0,0,0,0,0,0,0,0,0,0
2018-04-24,542151364809,708390000210,GracelandFruit莓果橙皮 混合果干 454克,菜鸟宁波保税1号仓,278,0,278,0,0,0,0,0,0,0,0,0,0,0,278,0,278,0,0,0,0,0,0,0,0,0,0,0,0,0,0,0
2018-04-24,542151596151,708390000227,GracelandFruit芒果莓果 混合果干 454克,菜鸟宁波保税1号仓,1,0,1,0,0,0,0,0,0,0,0,0,0,0,1,0,1,0,0,0,0,0,0,0,0,0,0,0,0,0,0,0
2018-04-24,542176430821,708390000203,GracelandFruit全美苹果 混合果干 454克,菜鸟宁波保税1号仓,354,0,354,0,0,0,0,0,0,0,0,0,0,0,354,0,354,0,0,0,0,0,0,0,0,0,0,0,0,0,0,0
2018-04-23,521783551638,XY521074093868,Graceland Fruit 蔓越莓切片果干 226.8克,菜鸟上海保税1号仓,300,300,0,0,0,0,0,0,0,0,0,0,0,0,300,300,0,0,0,0,0,0,0,0,0,0,0,0,0,0,0,0
2018-04-23,521786983343,XY521068155265,Graceland Fruit 整粒蔓越莓果干 1000克,菜鸟上海保税1号仓,59,59,0,0,0,0,0,0,0,0,0,0,0,0,59,59,0,0,0,0,0,0,0,0,0,0,0,0,0,0,0,0
2018-04-23,521795141212,XY521078390258,Graceland Fruit 整粒蔓越莓果干 226.8克,菜鸟上海保税1号仓,11759,287,11472,0,0,0,0,0,0,0,0,0,0,0,11759,287,11472,0,0,0,0,0,0,0,0,0,0,0,0,0,0,0
2018-04-23,521798656939,XY521074725008,Graceland Fruit 蔓越莓切片果干 1000克,菜鸟上海保税1号仓,191,191,0,0,0,0,0,0,0,0,0,0,0,0,191,191,0,0,0,0,0,0,0,0,0,0,0,0,0,0,0,0
2018-04-23,521798712600,XY521078064529,Graceland Fruit 酸樱桃果干 141.7克,菜鸟上海保税1号仓,496,496,0,0,0,0,0,0,0,0,0,0,0,0,496,496,0,0,0,0,0,0,0,0,0,0,0,0,0,0,0,0
2018-04-23,521798716403,XY521077912497,Graceland Fruit 蓝莓果干 1000克,菜鸟上海保税1号仓,68,68,0,0,0,0,0,0,0,0,0,0,0,0,68,68,0,0,0,0,0,0,0,0,0,0,0,0,0,0,0,0
2018-04-23,521799186703,XY521073901132,Graceland Fruit 蓝莓果干 141.7克,菜鸟上海保税1号仓,4785,482,4303,0,0,0,0,0,0,0,0,0,0,0,4785,482,4303,0,0,0,0,0,0,0,0,0,0,0,0,0,0,0
2018-04-23,521799426484,XY521074249153,Graceland Fruit 酸樱桃果干 1000克,菜鸟上海保税1号仓,117,117,0,0,0,0,0,0,0,0,0,0,0,0,117,117,0,0,0,0,0,0,0,0,0,0,0,0,0,0,0,0
2018-04-23,542151364809,708390000210,GracelandFruit莓果橙皮 混合果干 454克,菜鸟上海保税1号仓,42,42,0,0,0,0,0,0,0,0,0,0,0,0,42,42,0,0,0,0,0,0,0,0,0,0,0,0,0,0,0,0
2018-04-23,542151596151,708390000227,GracelandFruit芒果莓果 混合果干 454克,菜鸟上海保税1号仓,19,19,0,0,0,0,0,0,0,0,0,0,0,0,19,19,0,0,0,0,0,0,0,0,0,0,0,0,0,0,0,0
2018-04-23,562082510339,8802534778019,Graceland Fruit整粒蔓越莓黑巧克力,菜鸟上海保税1号仓,1770,1770,0,0,0,0,0,0,0,0,0,0,0,0,1770,1770,0,0,0,0,0,0,0,0,0,0,0,0,0,0,0,0
2018-04-23,562106910483,8802534778002,Graceland Fruit蓝莓黑巧克力,菜鸟上海保税1号仓,1400,1400,0,0,0,0,0,0,0,0,0,0,0,0,1400,1400,0,0,0,0,0,0,0,0,0,0,0,0,0,0,0,0
2018-04-23,565284028009,X708390000326,美国果瑞氏无糖蔓越莓果干113.4克,菜鸟上海保税1号仓,300,300,0,0,0,0,0,0,0,0,0,0,0,0,300,300,0,0,0,0,0,0,0,0,0,0,0,0,0,0,0,0
2018-04-23,521783799351,XY521067771349,Graceland Fruit 整粒蔓越莓果干 40克,菜鸟宁波保税1号仓,6,0,6,0,0,0,0,0,0,0,0,0,0,0,6,0,6,0,0,0,0,0,0,0,0,0,0,0,0,0,0,0
2018-04-23,521795141212,XY521078390258,Graceland Fruit 整粒蔓越莓果干 226.8克,菜鸟宁波保税1号仓,1,0,1,0,0,0,0,0,0,0,0,0,0,0,1,0,1,0,0,0,0,0,0,0,0,0,0,0,0,0,0,0
2018-04-23,521799186703,XY521073901132,Graceland Fruit 蓝莓果干 141.7克,菜鸟宁波保税1号仓,3,3,0,0,0,0,0,0,0,0,0,0,0,0,3,3,0,0,0,0,0,0,0,0,0,0,0,0,0,0,0,0
2018-04-23,542151364809,708390000210,GracelandFruit莓果橙皮 混合果干 454克,菜鸟宁波保税1号仓,278,0,278,0,0,0,0,0,0,0,0,0,0,0,278,0,278,0,0,0,0,0,0,0,0,0,0,0,0,0,0,0
2018-04-23,542151596151,708390000227,GracelandFruit芒果莓果 混合果干 454克,菜鸟宁波保税1号仓,1,0,1,0,0,0,0,0,0,0,0,0,0,0,1,0,1,0,0,0,0,0,0,0,0,0,0,0,0,0,0,0
2018-04-23,542176430821,708390000203,GracelandFruit全美苹果 混合果干 454克,菜鸟宁波保税1号仓,354,0,354,0,0,0,0,0,0,0,0,0,0,0,354,0,354,0,0,0,0,0,0,0,0,0,0,0,0,0,0,0
2018-04-22,521783551638,XY521074093868,Graceland Fruit 蔓越莓切片果干 226.8克,菜鸟上海保税1号仓,300,300,0,0,0,0,0,0,0,0,0,0,0,0,300,300,0,0,0,0,0,0,0,0,0,0,0,0,0,0,0,0
2018-04-22,521786983343,XY521068155265,Graceland Fruit 整粒蔓越莓果干 1000克,菜鸟上海保税1号仓,59,59,0,0,0,0,0,0,0,0,0,0,0,0,59,59,0,0,0,0,0,0,0,0,0,0,0,0,0,0,0,0
2018-04-22,521795141212,XY521078390258,Graceland Fruit 整粒蔓越莓果干 226.8克,菜鸟上海保税1号仓,11765,293,11472,0,0,0,0,0,6,6,0,0,0,0,11759,287,11472,0,0,0,0,0,0,0,0,0,0,0,0,0,0,0
2018-04-22,521798656939,XY521074725008,Graceland Fruit 蔓越莓切片果干 1000克,菜鸟上海保税1号仓,191,191,0,0,0,0,0,0,0,0,0,0,0,0,191,191,0,0,0,0,0,0,0,0,0,0,0,0,0,0,0,0
2018-04-22,521798712600,XY521078064529,Graceland Fruit 酸樱桃果干 141.7克,菜鸟上海保税1号仓,496,496,0,0,0,0,0,0,0,0,0,0,0,0,496,496,0,0,0,0,0,0,0,0,0,0,0,0,0,0,0,0
2018-04-22,521798716403,XY521077912497,Graceland Fruit 蓝莓果干 1000克,菜鸟上海保税1号仓,68,68,0,0,0,0,0,0,0,0,0,0,0,0,68,68,0,0,0,0,0,0,0,0,0,0,0,0,0,0,0,0
2018-04-22,521799186703,XY521073901132,Graceland Fruit 蓝莓果干 141.7克,菜鸟上海保税1号仓,4787,484,4303,0,0,0,0,0,2,2,0,0,0,0,4785,482,4303,0,0,0,0,0,0,0,0,0,0,0,0,0,0,0
2018-04-22,521799426484,XY521074249153,Graceland Fruit 酸樱桃果干 1000克,菜鸟上海保税1号仓,117,117,0,0,0,0,0,0,0,0,0,0,0,0,117,117,0,0,0,0,0,0,0,0,0,0,0,0,0,0,0,0
2018-04-22,542151364809,708390000210,GracelandFruit莓果橙皮 混合果干 454克,菜鸟上海保税1号仓,42,42,0,0,0,0,0,0,0,0,0,0,0,0,42,42,0,0,0,0,0,0,0,0,0,0,0,0,0,0,0,0
2018-04-22,542151596151,708390000227,GracelandFruit芒果莓果 混合果干 454克,菜鸟上海保税1号仓,19,19,0,0,0,0,0,0,0,0,0,0,0,0,19,19,0,0,0,0,0,0,0,0,0,0,0,0,0,0,0,0
2018-04-22,562082510339,8802534778019,Graceland Fruit整粒蔓越莓黑巧克力,菜鸟上海保税1号仓,1770,1770,0,0,0,0,0,0,0,0,0,0,0,0,1770,1770,0,0,0,0,0,0,0,0,0,0,0,0,0,0,0,0
2018-04-22,562106910483,8802534778002,Graceland Fruit蓝莓黑巧克力,菜鸟上海保税1号仓,1400,1400,0,0,0,0,0,0,0,0,0,0,0,0,1400,1400,0,0,0,0,0,0,0,0,0,0,0,0,0,0,0,0
2018-04-22,565284028009,X708390000326,美国果瑞氏无糖蔓越莓果干113.4克,菜鸟上海保税1号仓,300,300,0,0,0,0,0,0,0,0,0,0,0,0,300,300,0,0,0,0,0,0,0,0,0,0,0,0,0,0,0,0
2018-04-22,521783799351,XY521067771349,Graceland Fruit 整粒蔓越莓果干 40克,菜鸟宁波保税1号仓,6,0,6,0,0,0,0,0,0,0,0,0,0,0,6,0,6,0,0,0,0,0,0,0,0,0,0,0,0,0,0,0
2018-04-22,521795141212,XY521078390258,Graceland Fruit 整粒蔓越莓果干 226.8克,菜鸟宁波保税1号仓,1,0,1,0,0,0,0,0,0,0,0,0,0,0,1,0,1,0,0,0,0,0,0,0,0,0,0,0,0,0,0,0
2018-04-22,521799186703,XY521073901132,Graceland Fruit 蓝莓果干 141.7克,菜鸟宁波保税1号仓,3,3,0,0,0,0,0,0,0,0,0,0,0,0,3,3,0,0,0,0,0,0,0,0,0,0,0,0,0,0,0,0
2018-04-22,542151364809,708390000210,GracelandFruit莓果橙皮 混合果干 454克,菜鸟宁波保税1号仓,278,0,278,0,0,0,0,0,0,0,0,0,0,0,278,0,278,0,0,0,0,0,0,0,0,0,0,0,0,0,0,0
2018-04-22,542151596151,708390000227,GracelandFruit芒果莓果 混合果干 454克,菜鸟宁波保税1号仓,1,0,1,0,0,0,0,0,0,0,0,0,0,0,1,0,1,0,0,0,0,0,0,0,0,0,0,0,0,0,0,0
2018-04-22,542176430821,708390000203,GracelandFruit全美苹果 混合果干 454克,菜鸟宁波保税1号仓,354,0,354,0,0,0,0,0,0,0,0,0,0,0,354,0,354,0,0,0,0,0,0,0,0,0,0,0,0,0,0,0
2018-04-21,521783551638,XY521074093868,Graceland Fruit 蔓越莓切片果干 226.8克,菜鸟上海保税1号仓,300,300,0,0,0,0,0,0,0,0,0,0,0,0,300,300,0,0,0,0,0,0,0,0,0,0,0,0,0,0,0,0
2018-04-21,521786983343,XY521068155265,Graceland Fruit 整粒蔓越莓果干 1000克,菜鸟上海保税1号仓,59,59,0,0,0,0,0,0,0,0,0,0,0,0,59,59,0,0,0,0,0,0,0,0,0,0,0,0,0,0,0,0
2018-04-21,521795141212,XY521078390258,Graceland Fruit 整粒蔓越莓果干 226.8克,菜鸟上海保税1号仓,11765,293,11472,0,0,0,0,0,0,0,0,0,0,0,11765,293,11472,0,0,0,0,0,0,0,0,0,0,0,0,0,0,0
2018-04-21,521798656939,XY521074725008,Graceland Fruit 蔓越莓切片果干 1000克,菜鸟上海保税1号仓,191,191,0,0,0,0,0,0,0,0,0,0,0,0,191,191,0,0,0,0,0,0,0,0,0,0,0,0,0,0,0,0
2018-04-21,521798712600,XY521078064529,Graceland Fruit 酸樱桃果干 141.7克,菜鸟上海保税1号仓,496,496,0,0,0,0,0,0,0,0,0,0,0,0,496,496,0,0,0,0,0,0,0,0,0,0,0,0,0,0,0,0
2018-04-21,521798716403,XY521077912497,Graceland Fruit 蓝莓果干 1000克,菜鸟上海保税1号仓,69,69,0,0,0,0,0,0,1,1,0,0,0,0,68,68,0,0,0,0,0,0,0,0,0,0,0,0,0,0,0,0
2018-04-21,521799186703,XY521073901132,Graceland Fruit 蓝莓果干 141.7克,菜鸟上海保税1号仓,4796,493,4303,0,0,0,0,0,9,9,0,0,0,0,4787,484,4303,0,0,0,0,0,0,0,0,0,0,0,0,0,0,0
2018-04-21,521799426484,XY521074249153,Graceland Fruit 酸樱桃果干 1000克,菜鸟上海保税1号仓,117,117,0,0,0,0,0,0,0,0,0,0,0,0,117,117,0,0,0,0,0,0,0,0,0,0,0,0,0,0,0,0
2018-04-21,542151364809,708390000210,GracelandFruit莓果橙皮 混合果干 454克,菜鸟上海保税1号仓,43,43,0,0,0,0,0,0,1,1,0,0,0,0,42,42,0,0,0,0,0,0,0,0,0,0,0,0,0,0,0,0
2018-04-21,542151596151,708390000227,GracelandFruit芒果莓果 混合果干 454克,菜鸟上海保税1号仓,19,19,0,0,0,0,0,0,0,0,0,0,0,0,19,19,0,0,0,0,0,0,0,0,0,0,0,0,0,0,0,0
2018-04-21,562082510339,8802534778019,Graceland Fruit整粒蔓越莓黑巧克力,菜鸟上海保税1号仓,1773,1773,0,0,0,0,0,0,3,3,0,0,0,0,1770,1770,0,0,0,0,0,0,0,0,0,0,0,0,0,0,0,0
2018-04-21,562106910483,8802534778002,Graceland Fruit蓝莓黑巧克力,菜鸟上海保税1号仓,1405,1405,0,0,0,0,0,0,5,5,0,0,0,0,1400,1400,0,0,0,0,0,0,0,0,0,0,0,0,0,0,0,0
2018-04-21,565284028009,X708390000326,美国果瑞氏无糖蔓越莓果干113.4克,菜鸟上海保税1号仓,300,300,0,0,0,0,0,0,0,0,0,0,0,0,300,300,0,0,0,0,0,0,0,0,0,0,0,0,0,0,0,0
2018-04-21,521783799351,XY521067771349,Graceland Fruit 整粒蔓越莓果干 40克,菜鸟宁波保税1号仓,6,0,6,0,0,0,0,0,0,0,0,0,0,0,6,0,6,0,0,0,0,0,0,0,0,0,0,0,0,0,0,0
2018-04-21,521795141212,XY521078390258,Graceland Fruit 整粒蔓越莓果干 226.8克,菜鸟宁波保税1号仓,1,0,1,0,0,0,0,0,0,0,0,0,0,0,1,0,1,0,0,0,0,0,0,0,0,0,0,0,0,0,0,0
2018-04-21,521799186703,XY521073901132,Graceland Fruit 蓝莓果干 141.7克,菜鸟宁波保税1号仓,3,3,0,0,0,0,0,0,0,0,0,0,0,0,3,3,0,0,0,0,0,0,0,0,0,0,0,0,0,0,0,0
2018-04-21,542151364809,708390000210,GracelandFruit莓果橙皮 混合果干 454克,菜鸟宁波保税1号仓,278,0,278,0,0,0,0,0,0,0,0,0,0,0,278,0,278,0,0,0,0,0,0,0,0,0,0,0,0,0,0,0
2018-04-21,542151596151,708390000227,GracelandFruit芒果莓果 混合果干 454克,菜鸟宁波保税1号仓,1,0,1,0,0,0,0,0,0,0,0,0,0,0,1,0,1,0,0,0,0,0,0,0,0,0,0,0,0,0,0,0
2018-04-21,542176430821,708390000203,GracelandFruit全美苹果 混合果干 454克,菜鸟宁波保税1号仓,354,0,354,0,0,0,0,0,0,0,0,0,0,0,354,0,354,0,0,0,0,0,0,0,0,0,0,0,0,0,0,0
2018-04-20,521783551638,XY521074093868,Graceland Fruit 蔓越莓切片果干 226.8克,菜鸟上海保税1号仓,300,300,0,0,0,0,0,0,0,0,0,0,0,0,300,300,0,0,0,0,0,0,0,0,0,0,0,0,0,0,0,0
2018-04-20,521786983343,XY521068155265,Graceland Fruit 整粒蔓越莓果干 1000克,菜鸟上海保税1号仓,63,63,0,0,0,0,0,0,4,4,0,0,0,0,59,59,0,0,0,0,0,0,0,0,0,0,0,0,0,0,0,0
2018-04-20,521795141212,XY521078390258,Graceland Fruit 整粒蔓越莓果干 226.8克,菜鸟上海保税1号仓,11772,300,11472,0,0,0,0,0,7,7,0,0,0,0,11765,293,11472,0,0,0,0,0,0,0,0,0,0,0,0,0,0,0
2018-04-20,521798656939,XY521074725008,Graceland Fruit 蔓越莓切片果干 1000克,菜鸟上海保税1号仓,191,191,0,0,0,0,0,0,0,0,0,0,0,0,191,191,0,0,0,0,0,0,0,0,0,0,0,0,0,0,0,0
2018-04-20,521798712600,XY521078064529,Graceland Fruit 酸樱桃果干 141.7克,菜鸟上海保税1号仓,500,500,0,0,0,0,0,0,4,4,0,0,0,0,496,496,0,0,0,0,0,0,0,0,0,0,0,0,0,0,0,0
2018-04-20,521798716403,XY521077912497,Graceland Fruit 蓝莓果干 1000克,菜鸟上海保税1号仓,73,73,0,0,0,0,0,0,4,4,0,0,0,0,69,69,0,0,0,0,0,0,0,0,0,0,0,0,0,0,0,0
2018-04-20,521799186703,XY521073901132,Graceland Fruit 蓝莓果干 141.7克,菜鸟上海保税1号仓,4803,500,4303,0,0,0,0,0,7,7,0,0,0,0,4796,493,4303,0,0,0,0,0,0,0,0,0,0,0,0,0,0,0
2018-04-20,521799426484,XY521074249153,Graceland Fruit 酸樱桃果干 1000克,菜鸟上海保税1号仓,119,119,0,0,0,0,0,0,2,2,0,0,0,0,117,117,0,0,0,0,0,0,0,0,0,0,0,0,0,0,0,0
2018-04-20,542151364809,708390000210,GracelandFruit莓果橙皮 混合果干 454克,菜鸟上海保税1号仓,44,44,0,0,0,0,0,0,1,1,0,0,0,0,43,43,0,0,0,0,0,0,0,0,0,0,0,0,0,0,0,0
2018-04-20,542151596151,708390000227,GracelandFruit芒果莓果 混合果干 454克,菜鸟上海保税1号仓,20,20,0,0,0,0,0,0,1,1,0,0,0,0,19,19,0,0,0,0,0,0,0,0,0,0,0,0,0,0,0,0
2018-04-20,562082510339,8802534778019,Graceland Fruit整粒蔓越莓黑巧克力,菜鸟上海保税1号仓,1916,1916,0,0,0,0,0,0,143,143,0,0,0,0,1773,1773,0,0,0,0,0,0,0,0,0,0,0,0,0,0,0,0
2018-04-20,562106910483,8802534778002,Graceland Fruit蓝莓黑巧克力,菜鸟上海保税1号仓,1597,1597,0,0,0,0,0,0,192,192,0,0,0,0,1405,1405,0,0,0,0,0,0,0,0,0,0,0,0,0,0,0,0
2018-04-20,565284028009,X708390000326,美国果瑞氏无糖蔓越莓果干113.4克,菜鸟上海保税1号仓,300,300,0,0,0,0,0,0,0,0,0,0,0,0,300,300,0,0,0,0,0,0,0,0,0,0,0,0,0,0,0,0
2018-04-20,521783799351,XY521067771349,Graceland Fruit 整粒蔓越莓果干 40克,菜鸟宁波保税1号仓,6,0,6,0,0,0,0,0,0,0,0,0,0,0,6,0,6,0,0,0,0,0,0,0,0,0,0,0,0,0,0,0
2018-04-20,521795141212,XY521078390258,Graceland Fruit 整粒蔓越莓果干 226.8克,菜鸟宁波保税1号仓,1,0,1,0,0,0,0,0,0,0,0,0,0,0,1,0,1,0,0,0,0,0,0,0,0,0,0,0,0,0,0,0
2018-04-20,521799186703,XY521073901132,Graceland Fruit 蓝莓果干 141.7克,菜鸟宁波保税1号仓,3,3,0,0,0,0,0,0,0,0,0,0,0,0,3,3,0,0,0,0,0,0,0,0,0,0,0,0,0,0,0,0
2018-04-20,542151364809,708390000210,GracelandFruit莓果橙皮 混合果干 454克,菜鸟宁波保税1号仓,278,0,278,0,0,0,0,0,0,0,0,0,0,0,278,0,278,0,0,0,0,0,0,0,0,0,0,0,0,0,0,0
2018-04-20,542151596151,708390000227,GracelandFruit芒果莓果 混合果干 454克,菜鸟宁波保税1号仓,1,0,1,0,0,0,0,0,0,0,0,0,0,0,1,0,1,0,0,0,0,0,0,0,0,0,0,0,0,0,0,0
2018-04-20,542176430821,708390000203,GracelandFruit全美苹果 混合果干 454克,菜鸟宁波保税1号仓,354,0,354,0,0,0,0,0,0,0,0,0,0,0,354,0,354,0,0,0,0,0,0,0,0,0,0,0,0,0,0,0
2018-04-19,521783551638,XY521074093868,Graceland Fruit 蔓越莓切片果干 226.8克,菜鸟上海保税1号仓,0,0,0,600,600,0,0,0,300,0,300,0,0,0,300,300,0,0,0,0,0,0,0,300,300,0,0,0,0,300,300,0
2018-04-19,521786983343,XY521068155265,Graceland Fruit 整粒蔓越莓果干 1000克,菜鸟上海保税1号仓,63,63,0,0,0,0,0,0,0,0,0,0,0,0,63,63,0,0,0,0,0,0,0,0,0,0,0,0,0,0,0,0
2018-04-19,521795141212,XY521078390258,Graceland Fruit 整粒蔓越莓果干 226.8克,菜鸟上海保税1号仓,11472,0,11472,600,600,0,0,0,300,0,300,0,0,0,11772,300,11472,0,0,0,0,0,0,300,300,0,0,0,0,300,300,0
2018-04-19,521798656939,XY521074725008,Graceland Fruit 蔓越莓切片果干 1000克,菜鸟上海保税1号仓,191,191,0,0,0,0,0,0,0,0,0,0,0,0,191,191,0,0,0,0,0,0,0,0,0,0,0,0,0,0,0,0
2018-04-19,521798712600,XY521078064529,Graceland Fruit 酸樱桃果干 141.7克,菜鸟上海保税1号仓,0,0,0,1000,1000,0,0,0,500,0,500,0,0,0,500,500,0,0,0,0,0,0,0,500,500,0,0,0,0,500,500,0
2018-04-19,521798716403,XY521077912497,Graceland Fruit 蓝莓果干 1000克,菜鸟上海保税1号仓,73,73,0,0,0,0,0,0,0,0,0,0,0,0,73,73,0,0,0,0,0,0,0,0,0,0,0,0,0,0,0,0
2018-04-19,521799186703,XY521073901132,Graceland Fruit 蓝莓果干 141.7克,菜鸟上海保税1号仓,4303,0,4303,1000,1000,0,0,0,500,0,500,0,0,0,4803,500,4303,0,0,0,0,0,0,500,500,0,0,0,0,500,500,0
2018-04-19,521799426484,XY521074249153,Graceland Fruit 酸樱桃果干 1000克,菜鸟上海保税1号仓,119,119,0,0,0,0,0,0,0,0,0,0,0,0,119,119,0,0,0,0,0,0,0,0,0,0,0,0,0,0,0,0
2018-04-19,542151364809,708390000210,GracelandFruit莓果橙皮 混合果干 454克,菜鸟上海保税1号仓,44,44,0,0,0,0,0,0,0,0,0,0,0,0,44,44,0,0,0,0,0,0,0,0,0,0,0,0,0,0,0,0
2018-04-19,542151596151,708390000227,GracelandFruit芒果莓果 混合果干 454克,菜鸟上海保税1号仓,20,20,0,0,0,0,0,0,0,0,0,0,0,0,20,20,0,0,0,0,0,0,0,0,0,0,0,0,0,0,0,0
2018-04-19,562082510339,8802534778019,Graceland Fruit整粒蔓越莓黑巧克力,菜鸟上海保税1号仓,1928,1928,0,0,0,0,0,0,12,12,0,0,0,0,1916,1916,0,0,0,0,0,0,0,0,0,0,0,0,0,0,0,0
2018-04-19,562106910483,8802534778002,Graceland Fruit蓝莓黑巧克力,菜鸟上海保税1号仓,1624,1624,0,0,0,0,0,0,27,27,0,0,0,0,1597,1597,0,0,0,0,0,0,0,0,0,0,0,0,0,0,0,0
2018-04-19,565284028009,X708390000326,美国果瑞氏无糖蔓越莓果干113.4克,菜鸟上海保税1号仓,0,0,0,600,600,0,0,0,300,0,300,0,0,0,300,300,0,0,0,0,0,0,0,300,300,0,0,0,0,300,300,0
2018-04-19,521783799351,XY521067771349,Graceland Fruit 整粒蔓越莓果干 40克,菜鸟宁波保税1号仓,6,0,6,0,0,0,0,0,0,0,0,0,0,0,6,0,6,0,0,0,0,0,0,0,0,0,0,0,0,0,0,0
2018-04-19,521795141212,XY521078390258,Graceland Fruit 整粒蔓越莓果干 226.8克,菜鸟宁波保税1号仓,1,0,1,0,0,0,0,0,0,0,0,0,0,0,1,0,1,0,0,0,0,0,0,0,0,0,0,0,0,0,0,0
2018-04-19,521799186703,XY521073901132,Graceland Fruit 蓝莓果干 141.7克,菜鸟宁波保税1号仓,3,3,0,0,0,0,0,0,0,0,0,0,0,0,3,3,0,0,0,0,0,0,0,0,0,0,0,0,0,0,0,0
2018-04-19,542151364809,708390000210,GracelandFruit莓果橙皮 混合果干 454克,菜鸟宁波保税1号仓,278,0,278,0,0,0,0,0,0,0,0,0,0,0,278,0,278,0,0,0,0,0,0,0,0,0,0,0,0,0,0,0
2018-04-19,542151596151,708390000227,GracelandFruit芒果莓果 混合果干 454克,菜鸟宁波保税1号仓,1,0,1,0,0,0,0,0,0,0,0,0,0,0,1,0,1,0,0,0,0,0,0,0,0,0,0,0,0,0,0,0
2018-04-19,542176430821,708390000203,GracelandFruit全美苹果 混合果干 454克,菜鸟宁波保税1号仓,354,0,354,0,0,0,0,0,0,0,0,0,0,0,354,0,354,0,0,0,0,0,0,0,0,0,0,0,0,0,0,0
2018-04-18,521783551638,XY521074093868,Graceland Fruit 蔓越莓切片果干 226.8克,菜鸟上海保税1号仓,0,0,0,0,0,0,0,0,0,0,0,0,0,0,0,0,0,300,0,0,0,0,0,0,0,0,0,0,0,0,0,0
2018-04-18,521786983343,XY521068155265,Graceland Fruit 整粒蔓越莓果干 1000克,菜鸟上海保税1号仓,72,72,0,0,0,0,0,0,9,9,0,0,0,0,63,63,0,0,0,0,0,0,0,0,0,0,0,0,0,0,0,0
2018-04-18,521795141212,XY521078390258,Graceland Fruit 整粒蔓越莓果干 226.8克,菜鸟上海保税1号仓,11472,0,11472,0,0,0,0,0,0,0,0,0,0,0,11472,0,11472,300,0,0,0,0,0,0,0,0,0,0,0,0,0,0
2018-04-18,521798656939,XY521074725008,Graceland Fruit 蔓越莓切片果干 1000克,菜鸟上海保税1号仓,191,191,0,0,0,0,0,0,0,0,0,0,0,0,191,191,0,0,0,0,0,0,0,0,0,0,0,0,0,0,0,0
2018-04-18,521798712600,XY521078064529,Graceland Fruit 酸樱桃果干 141.7克,菜鸟上海保税1号仓,0,0,0,0,0,0,0,0,0,0,0,0,0,0,0,0,0,500,0,0,0,0,0,0,0,0,0,0,0,0,0,0
2018-04-18,521798716403,XY521077912497,Graceland Fruit 蓝莓果干 1000克,菜鸟上海保税1号仓,74,74,0,0,0,0,0,0,1,1,0,0,0,0,73,73,0,0,0,0,0,0,0,0,0,0,0,0,0,0,0,0
2018-04-18,521799186703,XY521073901132,Graceland Fruit 蓝莓果干 141.7克,菜鸟上海保税1号仓,4303,0,4303,0,0,0,0,0,0,0,0,0,0,0,4303,0,4303,500,0,0,0,0,0,0,0,0,0,0,0,0,0,0
2018-04-18,521799426484,XY521074249153,Graceland Fruit 酸樱桃果干 1000克,菜鸟上海保税1号仓,121,121,0,0,0,0,0,0,2,2,0,0,0,0,119,119,0,0,0,0,0,0,0,0,0,0,0,0,0,0,0,0
2018-04-18,542151364809,708390000210,GracelandFruit莓果橙皮 混合果干 454克,菜鸟上海保税1号仓,46,46,0,0,0,0,0,0,2,2,0,0,0,0,44,44,0,0,0,0,0,0,0,0,0,0,0,0,0,0,0,0
2018-04-18,542151596151,708390000227,GracelandFruit芒果莓果 混合果干 454克,菜鸟上海保税1号仓,20,20,0,0,0,0,0,0,0,0,0,0,0,0,20,20,0,0,0,0,0,0,0,0,0,0,0,0,0,0,0,0
2018-04-18,562082510339,8802534778019,Graceland Fruit整粒蔓越莓黑巧克力,菜鸟上海保税1号仓,2170,2170,0,0,0,0,0,0,242,242,0,0,0,0,1928,1928,0,0,0,0,0,0,0,0,0,0,0,0,0,0,0,0
2018-04-18,562106910483,8802534778002,Graceland Fruit蓝莓黑巧克力,菜鸟上海保税1号仓,2104,2104,0,0,0,0,0,0,480,480,0,0,0,0,1624,1624,0,0,0,0,0,0,0,0,0,0,0,0,0,0,0,0
2018-04-18,565284028009,X708390000326,美国果瑞氏无糖蔓越莓果干113.4克,菜鸟上海保税1号仓,0,0,0,0,0,0,0,0,0,0,0,0,0,0,0,0,0,300,0,0,0,0,0,0,0,0,0,0,0,0,0,0
2018-04-18,521783799351,XY521067771349,Graceland Fruit 整粒蔓越莓果干 40克,菜鸟宁波保税1号仓,6,0,6,0,0,0,0,0,0,0,0,0,0,0,6,0,6,0,0,0,0,0,0,0,0,0,0,0,0,0,0,0
2018-04-18,521795141212,XY521078390258,Graceland Fruit 整粒蔓越莓果干 226.8克,菜鸟宁波保税1号仓,1,0,1,0,0,0,0,0,0,0,0,0,0,0,1,0,1,0,0,0,0,0,0,0,0,0,0,0,0,0,0,0
2018-04-18,521799186703,XY521073901132,Graceland Fruit 蓝莓果干 141.7克,菜鸟宁波保税1号仓,3,3,0,0,0,0,0,0,0,0,0,0,0,0,3,3,0,0,0,0,0,0,0,0,0,0,0,0,0,0,0,0
2018-04-18,542151364809,708390000210,GracelandFruit莓果橙皮 混合果干 454克,菜鸟宁波保税1号仓,278,0,278,0,0,0,0,0,0,0,0,0,0,0,278,0,278,0,0,0,0,0,0,0,0,0,0,0,0,0,0,0
2018-04-18,542151596151,708390000227,GracelandFruit芒果莓果 混合果干 454克,菜鸟宁波保税1号仓,1,0,1,0,0,0,0,0,0,0,0,0,0,0,1,0,1,0,0,0,0,0,0,0,0,0,0,0,0,0,0,0
2018-04-18,542176430821,708390000203,GracelandFruit全美苹果 混合果干 454克,菜鸟宁波保税1号仓,354,0,354,0,0,0,0,0,0,0,0,0,0,0,354,0,354,0,0,0,0,0,0,0,0,0,0,0,0,0,0,0
2018-04-17,521786983343,XY521068155265,Graceland Fruit 整粒蔓越莓果干 1000克,菜鸟上海保税1号仓,74,74,0,0,0,0,0,0,2,2,0,0,0,0,72,72,0,0,0,0,0,0,0,0,0,0,0,0,0,0,0,0
2018-04-17,521795141212,XY521078390258,Graceland Fruit 整粒蔓越莓果干 226.8克,菜鸟上海保税1号仓,11472,0,11472,0,0,0,0,0,0,0,0,0,0,0,11472,0,11472,0,0,0,0,0,0,0,0,0,0,0,0,0,0,0
2018-04-17,521798656939,XY521074725008,Graceland Fruit 蔓越莓切片果干 1000克,菜鸟上海保税1号仓,191,191,0,0,0,0,0,0,0,0,0,0,0,0,191,191,0,0,0,0,0,0,0,0,0,0,0,0,0,0,0,0
2018-04-17,521798716403,XY521077912497,Graceland Fruit 蓝莓果干 1000克,菜鸟上海保税1号仓,75,75,0,0,0,0,0,0,1,1,0,0,0,0,74,74,0,0,0,0,0,0,0,0,0,0,0,0,0,0,0,0
2018-04-17,521799186703,XY521073901132,Graceland Fruit 蓝莓果干 141.7克,菜鸟上海保税1号仓,4303,0,4303,0,0,0,0,0,0,0,0,0,0,0,4303,0,4303,0,0,0,0,0,0,0,0,0,0,0,0,0,0,0
2018-04-17,521799426484,XY521074249153,Graceland Fruit 酸樱桃果干 1000克,菜鸟上海保税1号仓,121,121,0,0,0,0,0,0,0,0,0,0,0,0,121,121,0,0,0,0,0,0,0,0,0,0,0,0,0,0,0,0
2018-04-17,542151364809,708390000210,GracelandFruit莓果橙皮 混合果干 454克,菜鸟上海保税1号仓,46,46,0,0,0,0,0,0,0,0,0,0,0,0,46,46,0,0,0,0,0,0,0,0,0,0,0,0,0,0,0,0
2018-04-17,542151596151,708390000227,GracelandFruit芒果莓果 混合果干 454克,菜鸟上海保税1号仓,20,20,0,0,0,0,0,0,0,0,0,0,0,0,20,20,0,0,0,0,0,0,0,0,0,0,0,0,0,0,0,0
2018-04-17,562082510339,8802534778019,Graceland Fruit整粒蔓越莓黑巧克力,菜鸟上海保税1号仓,2170,2170,0,0,0,0,0,0,0,0,0,0,0,0,2170,2170,0,0,0,0,0,0,0,0,0,0,0,0,0,0,0,0
2018-04-17,562106910483,8802534778002,Graceland Fruit蓝莓黑巧克力,菜鸟上海保税1号仓,2104,2104,0,0,0,0,0,0,0,0,0,0,0,0,2104,2104,0,0,0,0,0,0,0,0,0,0,0,0,0,0,0,0
2018-04-17,521783799351,XY521067771349,Graceland Fruit 整粒蔓越莓果干 40克,菜鸟宁波保税1号仓,6,0,6,0,0,0,0,0,0,0,0,0,0,0,6,0,6,0,0,0,0,0,0,0,0,0,0,0,0,0,0,0
2018-04-17,521795141212,XY521078390258,Graceland Fruit 整粒蔓越莓果干 226.8克,菜鸟宁波保税1号仓,1,0,1,0,0,0,0,0,0,0,0,0,0,0,1,0,1,0,0,0,0,0,0,0,0,0,0,0,0,0,0,0
2018-04-17,521799186703,XY521073901132,Graceland Fruit 蓝莓果干 141.7克,菜鸟宁波保税1号仓,3,3,0,0,0,0,0,0,0,0,0,0,0,0,3,3,0,0,0,0,0,0,0,0,0,0,0,0,0,0,0,0
2018-04-17,542151364809,708390000210,GracelandFruit莓果橙皮 混合果干 454克,菜鸟宁波保税1号仓,278,0,278,0,0,0,0,0,0,0,0,0,0,0,278,0,278,0,0,0,0,0,0,0,0,0,0,0,0,0,0,0
2018-04-17,542151596151,708390000227,GracelandFruit芒果莓果 混合果干 454克,菜鸟宁波保税1号仓,1,0,1,0,0,0,0,0,0,0,0,0,0,0,1,0,1,0,0,0,0,0,0,0,0,0,0,0,0,0,0,0
2018-04-17,542176430821,708390000203,GracelandFruit全美苹果 混合果干 454克,菜鸟宁波保税1号仓,354,0,354,0,0,0,0,0,0,0,0,0,0,0,354,0,354,0,0,0,0,0,0,0,0,0,0,0,0,0,0,0
2018-04-16,521786983343,XY521068155265,Graceland Fruit 整粒蔓越莓果干 1000克,菜鸟上海保税1号仓,80,80,0,0,0,0,0,0,6,6,0,0,0,0,74,74,0,0,0,0,0,0,0,0,0,0,0,0,0,0,0,0
2018-04-16,521795141212,XY521078390258,Graceland Fruit 整粒蔓越莓果干 226.8克,菜鸟上海保税1号仓,11472,0,11472,0,0,0,0,0,0,0,0,0,0,0,11472,0,11472,0,0,0,0,0,0,0,0,0,0,0,0,0,0,0
2018-04-16,521798656939,XY521074725008,Graceland Fruit 蔓越莓切片果干 1000克,菜鸟上海保税1号仓,196,196,0,0,0,0,0,0,5,5,0,0,0,0,191,191,0,0,0,0,0,0,0,0,0,0,0,0,0,0,0,0
2018-04-16,521798716403,XY521077912497,Graceland Fruit 蓝莓果干 1000克,菜鸟上海保税1号仓,79,79,0,0,0,0,0,0,4,4,0,0,0,0,75,75,0,0,0,0,0,0,0,0,0,0,0,0,0,0,0,0
2018-04-16,521799186703,XY521073901132,Graceland Fruit 蓝莓果干 141.7克,菜鸟上海保税1号仓,4303,0,4303,0,0,0,0,0,0,0,0,0,0,0,4303,0,4303,0,0,0,0,0,0,0,0,0,0,0,0,0,0,0
2018-04-16,521799426484,XY521074249153,Graceland Fruit 酸樱桃果干 1000克,菜鸟上海保税1号仓,122,122,0,0,0,0,0,0,1,1,0,0,0,0,121,121,0,0,0,0,0,0,0,0,0,0,0,0,0,0,0,0
2018-04-16,542151364809,708390000210,GracelandFruit莓果橙皮 混合果干 454克,菜鸟上海保税1号仓,51,51,0,0,0,0,0,0,5,5,0,0,0,0,46,46,0,0,0,0,0,0,0,0,0,0,0,0,0,0,0,0
2018-04-16,542151596151,708390000227,GracelandFruit芒果莓果 混合果干 454克,菜鸟上海保税1号仓,23,23,0,0,0,0,0,0,3,3,0,0,0,0,20,20,0,0,0,0,0,0,0,0,0,0,0,0,0,0,0,0
2018-04-16,562082510339,8802534778019,Graceland Fruit整粒蔓越莓黑巧克力,菜鸟上海保税1号仓,2170,2170,0,0,0,0,0,0,0,0,0,0,0,0,2170,2170,0,0,0,0,0,0,0,0,0,0,0,0,0,0,0,0
2018-04-16,562106910483,8802534778002,Graceland Fruit蓝莓黑巧克力,菜鸟上海保税1号仓,2105,2105,0,0,0,0,0,0,1,1,0,0,0,0,2104,2104,0,0,0,0,0,0,0,0,0,0,0,0,0,0,0,0
2018-04-16,521783799351,XY521067771349,Graceland Fruit 整粒蔓越莓果干 40克,菜鸟宁波保税1号仓,6,0,6,0,0,0,0,0,0,0,0,0,0,0,6,0,6,0,0,0,0,0,0,0,0,0,0,0,0,0,0,0
2018-04-16,521795141212,XY521078390258,Graceland Fruit 整粒蔓越莓果干 226.8克,菜鸟宁波保税1号仓,1,0,1,0,0,0,0,0,0,0,0,0,0,0,1,0,1,0,0,0,0,0,0,0,0,0,0,0,0,0,0,0
2018-04-16,521799186703,XY521073901132,Graceland Fruit 蓝莓果干 141.7克,菜鸟宁波保税1号仓,3,3,0,0,0,0,0,0,0,0,0,0,0,0,3,3,0,0,0,0,0,0,0,0,0,0,0,0,0,0,0,0
2018-04-16,542151364809,708390000210,GracelandFruit莓果橙皮 混合果干 454克,菜鸟宁波保税1号仓,278,0,278,0,0,0,0,0,0,0,0,0,0,0,278,0,278,0,0,0,0,0,0,0,0,0,0,0,0,0,0,0
2018-04-16,542151596151,708390000227,GracelandFruit芒果莓果 混合果干 454克,菜鸟宁波保税1号仓,1,0,1,0,0,0,0,0,0,0,0,0,0,0,1,0,1,0,0,0,0,0,0,0,0,0,0,0,0,0,0,0
2018-04-16,542176430821,708390000203,GracelandFruit全美苹果 混合果干 454克,菜鸟宁波保税1号仓,354,0,354,0,0,0,0,0,0,0,0,0,0,0,354,0,354,0,0,0,0,0,0,0,0,0,0,0,0,0,0,0
2018-04-15,521786983343,XY521068155265,Graceland Fruit 整粒蔓越莓果干 1000克,菜鸟上海保税1号仓,80,80,0,0,0,0,0,0,0,0,0,0,0,0,80,80,0,0,0,0,0,0,0,0,0,0,0,0,0,0,0,0
2018-04-15,521795141212,XY521078390258,Graceland Fruit 整粒蔓越莓果干 226.8克,菜鸟上海保税1号仓,11472,0,11472,0,0,0,0,0,0,0,0,0,0,0,11472,0,11472,0,0,0,0,0,0,0,0,0,0,0,0,0,0,0
2018-04-15,521798656939,XY521074725008,Graceland Fruit 蔓越莓切片果干 1000克,菜鸟上海保税1号仓,196,196,0,0,0,0,0,0,0,0,0,0,0,0,196,196,0,0,0,0,0,0,0,0,0,0,0,0,0,0,0,0
2018-04-15,521798716403,XY521077912497,Graceland Fruit 蓝莓果干 1000克,菜鸟上海保税1号仓,79,79,0,0,0,0,0,0,0,0,0,0,0,0,79,79,0,0,0,0,0,0,0,0,0,0,0,0,0,0,0,0
2018-04-15,521799186703,XY521073901132,Graceland Fruit 蓝莓果干 141.7克,菜鸟上海保税1号仓,4303,0,4303,0,0,0,0,0,0,0,0,0,0,0,4303,0,4303,0,0,0,0,0,0,0,0,0,0,0,0,0,0,0
2018-04-15,521799426484,XY521074249153,Graceland Fruit 酸樱桃果干 1000克,菜鸟上海保税1号仓,122,122,0,0,0,0,0,0,0,0,0,0,0,0,122,122,0,0,0,0,0,0,0,0,0,0,0,0,0,0,0,0
2018-04-15,542151364809,708390000210,GracelandFruit莓果橙皮 混合果干 454克,菜鸟上海保税1号仓,51,51,0,0,0,0,0,0,0,0,0,0,0,0,51,51,0,0,0,0,0,0,0,0,0,0,0,0,0,0,0,0
2018-04-15,542151596151,708390000227,GracelandFruit芒果莓果 混合果干 454克,菜鸟上海保税1号仓,23,23,0,0,0,0,0,0,0,0,0,0,0,0,23,23,0,0,0,0,0,0,0,0,0,0,0,0,0,0,0,0
2018-04-15,562082510339,8802534778019,Graceland Fruit整粒蔓越莓黑巧克力,菜鸟上海保税1号仓,2170,2170,0,0,0,0,0,0,0,0,0,0,0,0,2170,2170,0,0,0,0,0,0,0,0,0,0,0,0,0,0,0,0
2018-04-15,562106910483,8802534778002,Graceland Fruit蓝莓黑巧克力,菜鸟上海保税1号仓,2105,2105,0,0,0,0,0,0,0,0,0,0,0,0,2105,2105,0,0,0,0,0,0,0,0,0,0,0,0,0,0,0,0
2018-04-15,521783799351,XY521067771349,Graceland Fruit 整粒蔓越莓果干 40克,菜鸟宁波保税1号仓,6,0,6,0,0,0,0,0,0,0,0,0,0,0,6,0,6,0,0,0,0,0,0,0,0,0,0,0,0,0,0,0
2018-04-15,521795141212,XY521078390258,Graceland Fruit 整粒蔓越莓果干 226.8克,菜鸟宁波保税1号仓,1,0,1,0,0,0,0,0,0,0,0,0,0,0,1,0,1,0,0,0,0,0,0,0,0,0,0,0,0,0,0,0
2018-04-15,521799186703,XY521073901132,Graceland Fruit 蓝莓果干 141.7克,菜鸟宁波保税1号仓,3,3,0,0,0,0,0,0,0,0,0,0,0,0,3,3,0,0,0,0,0,0,0,0,0,0,0,0,0,0,0,0
2018-04-15,542151364809,708390000210,GracelandFruit莓果橙皮 混合果干 454克,菜鸟宁波保税1号仓,278,0,278,0,0,0,0,0,0,0,0,0,0,0,278,0,278,0,0,0,0,0,0,0,0,0,0,0,0,0,0,0
2018-04-15,542151596151,708390000227,GracelandFruit芒果莓果 混合果干 454克,菜鸟宁波保税1号仓,1,0,1,0,0,0,0,0,0,0,0,0,0,0,1,0,1,0,0,0,0,0,0,0,0,0,0,0,0,0,0,0
2018-04-15,542176430821,708390000203,GracelandFruit全美苹果 混合果干 454克,菜鸟宁波保税1号仓,354,0,354,0,0,0,0,0,0,0,0,0,0,0,354,0,354,0,0,0,0,0,0,0,0,0,0,0,0,0,0,0
2018-04-14,521786983343,XY521068155265,Graceland Fruit 整粒蔓越莓果干 1000克,菜鸟上海保税1号仓,80,80,0,0,0,0,0,0,0,0,0,0,0,0,80,80,0,0,0,0,0,0,0,0,0,0,0,0,0,0,0,0
2018-04-14,521795141212,XY521078390258,Graceland Fruit 整粒蔓越莓果干 226.8克,菜鸟上海保税1号仓,11472,0,11472,0,0,0,0,0,0,0,0,0,0,0,11472,0,11472,0,0,0,0,0,0,0,0,0,0,0,0,0,0,0
2018-04-14,521798656939,XY521074725008,Graceland Fruit 蔓越莓切片果干 1000克,菜鸟上海保税1号仓,196,196,0,0,0,0,0,0,0,0,0,0,0,0,196,196,0,0,0,0,0,0,0,0,0,0,0,0,0,0,0,0
2018-04-14,521798716403,XY521077912497,Graceland Fruit 蓝莓果干 1000克,菜鸟上海保税1号仓,79,79,0,0,0,0,0,0,0,0,0,0,0,0,79,79,0,0,0,0,0,0,0,0,0,0,0,0,0,0,0,0
2018-04-14,521799186703,XY521073901132,Graceland Fruit 蓝莓果干 141.7克,菜鸟上海保税1号仓,4303,0,4303,0,0,0,0,0,0,0,0,0,0,0,4303,0,4303,0,0,0,0,0,0,0,0,0,0,0,0,0,0,0
2018-04-14,521799426484,XY521074249153,Graceland Fruit 酸樱桃果干 1000克,菜鸟上海保税1号仓,122,122,0,0,0,0,0,0,0,0,0,0,0,0,122,122,0,0,0,0,0,0,0,0,0,0,0,0,0,0,0,0
2018-04-14,542151364809,708390000210,GracelandFruit莓果橙皮 混合果干 454克,菜鸟上海保税1号仓,51,51,0,0,0,0,0,0,0,0,0,0,0,0,51,51,0,0,0,0,0,0,0,0,0,0,0,0,0,0,0,0
2018-04-14,542151596151,708390000227,GracelandFruit芒果莓果 混合果干 454克,菜鸟上海保税1号仓,23,23,0,0,0,0,0,0,0,0,0,0,0,0,23,23,0,0,0,0,0,0,0,0,0,0,0,0,0,0,0,0
2018-04-14,562082510339,8802534778019,Graceland Fruit整粒蔓越莓黑巧克力,菜鸟上海保税1号仓,2170,2170,0,0,0,0,0,0,0,0,0,0,0,0,2170,2170,0,0,0,0,0,0,0,0,0,0,0,0,0,0,0,0
2018-04-14,562106910483,8802534778002,Graceland Fruit蓝莓黑巧克力,菜鸟上海保税1号仓,2105,2105,0,0,0,0,0,0,0,0,0,0,0,0,2105,2105,0,0,0,0,0,0,0,0,0,0,0,0,0,0,0,0
2018-04-14,521783799351,XY521067771349,Graceland Fruit 整粒蔓越莓果干 40克,菜鸟宁波保税1号仓,6,0,6,0,0,0,0,0,0,0,0,0,0,0,6,0,6,0,0,0,0,0,0,0,0,0,0,0,0,0,0,0
2018-04-14,521795141212,XY521078390258,Graceland Fruit 整粒蔓越莓果干 226.8克,菜鸟宁波保税1号仓,1,0,1,0,0,0,0,0,0,0,0,0,0,0,1,0,1,0,0,0,0,0,0,0,0,0,0,0,0,0,0,0
2018-04-14,521799186703,XY521073901132,Graceland Fruit 蓝莓果干 141.7克,菜鸟宁波保税1号仓,3,3,0,0,0,0,0,0,0,0,0,0,0,0,3,3,0,0,0,0,0,0,0,0,0,0,0,0,0,0,0,0
2018-04-14,542151364809,708390000210,GracelandFruit莓果橙皮 混合果干 454克,菜鸟宁波保税1号仓,278,0,278,0,0,0,0,0,0,0,0,0,0,0,278,0,278,0,0,0,0,0,0,0,0,0,0,0,0,0,0,0
2018-04-14,542151596151,708390000227,GracelandFruit芒果莓果 混合果干 454克,菜鸟宁波保税1号仓,1,0,1,0,0,0,0,0,0,0,0,0,0,0,1,0,1,0,0,0,0,0,0,0,0,0,0,0,0,0,0,0
2018-04-14,542176430821,708390000203,GracelandFruit全美苹果 混合果干 454克,菜鸟宁波保税1号仓,354,0,354,0,0,0,0,0,0,0,0,0,0,0,354,0,354,0,0,0,0,0,0,0,0,0,0,0,0,0,0,0
2018-04-13,521786983343,XY521068155265,Graceland Fruit 整粒蔓越莓果干 1000克,菜鸟上海保税1号仓,82,82,0,0,0,0,0,0,2,2,0,0,0,0,80,80,0,0,0,0,0,0,0,0,0,0,0,0,0,0,0,0
2018-04-13,521795141212,XY521078390258,Graceland Fruit 整粒蔓越莓果干 226.8克,菜鸟上海保税1号仓,11472,0,11472,0,0,0,0,0,0,0,0,0,0,0,11472,0,11472,0,0,0,0,0,0,0,0,0,0,0,0,0,0,0
2018-04-13,521798656939,XY521074725008,Graceland Fruit 蔓越莓切片果干 1000克,菜鸟上海保税1号仓,198,198,0,0,0,0,0,0,2,2,0,0,0,0,196,196,0,0,0,0,0,0,0,0,0,0,0,0,0,0,0,0
2018-04-13,521798716403,XY521077912497,Graceland Fruit 蓝莓果干 1000克,菜鸟上海保税1号仓,79,79,0,0,0,0,0,0,0,0,0,0,0,0,79,79,0,0,0,0,0,0,0,0,0,0,0,0,0,0,0,0
2018-04-13,521799186703,XY521073901132,Graceland Fruit 蓝莓果干 141.7克,菜鸟上海保税1号仓,4303,0,4303,0,0,0,0,0,0,0,0,0,0,0,4303,0,4303,0,0,0,0,0,0,0,0,0,0,0,0,0,0,0
2018-04-13,521799426484,XY521074249153,Graceland Fruit 酸樱桃果干 1000克,菜鸟上海保税1号仓,122,122,0,0,0,0,0,0,0,0,0,0,0,0,122,122,0,0,0,0,0,0,0,0,0,0,0,0,0,0,0,0
2018-04-13,542151364809,708390000210,GracelandFruit莓果橙皮 混合果干 454克,菜鸟上海保税1号仓,51,51,0,0,0,0,0,0,0,0,0,0,0,0,51,51,0,0,0,0,0,0,0,0,0,0,0,0,0,0,0,0
2018-04-13,542151596151,708390000227,GracelandFruit芒果莓果 混合果干 454克,菜鸟上海保税1号仓,25,25,0,0,0,0,0,0,2,0,2,0,2,0,23,23,0,0,0,0,0,0,0,0,0,0,0,0,0,0,0,0
2018-04-13,562082510339,8802534778019,Graceland Fruit整粒蔓越莓黑巧克力,菜鸟上海保税1号仓,2170,2170,0,0,0,0,0,0,0,0,0,0,0,0,2170,2170,0,0,0,0,0,0,0,0,0,0,0,0,0,0,0,0
2018-04-13,562106910483,8802534778002,Graceland Fruit蓝莓黑巧克力,菜鸟上海保税1号仓,2105,2105,0,0,0,0,0,0,0,0,0,0,0,0,2105,2105,0,0,0,0,0,0,0,0,0,0,0,0,0,0,0,0
2018-04-13,521783799351,XY521067771349,Graceland Fruit 整粒蔓越莓果干 40克,菜鸟宁波保税1号仓,6,0,6,0,0,0,0,0,0,0,0,0,0,0,6,0,6,0,0,0,0,0,0,0,0,0,0,0,0,0,0,0
2018-04-13,521795141212,XY521078390258,Graceland Fruit 整粒蔓越莓果干 226.8克,菜鸟宁波保税1号仓,1,0,1,0,0,0,0,0,0,0,0,0,0,0,1,0,1,0,0,0,0,0,0,0,0,0,0,0,0,0,0,0
2018-04-13,521799186703,XY521073901132,Graceland Fruit 蓝莓果干 141.7克,菜鸟宁波保税1号仓,3,3,0,0,0,0,0,0,0,0,0,0,0,0,3,3,0,0,0,0,0,0,0,0,0,0,0,0,0,0,0,0
2018-04-13,542151364809,708390000210,GracelandFruit莓果橙皮 混合果干 454克,菜鸟宁波保税1号仓,278,0,278,0,0,0,0,0,0,0,0,0,0,0,278,0,278,0,0,0,0,0,0,0,0,0,0,0,0,0,0,0
2018-04-13,542151596151,708390000227,GracelandFruit芒果莓果 混合果干 454克,菜鸟宁波保税1号仓,1,0,1,0,0,0,0,0,0,0,0,0,0,0,1,0,1,0,0,0,0,0,0,0,0,0,0,0,0,0,0,0
2018-04-13,542176430821,708390000203,GracelandFruit全美苹果 混合果干 454克,菜鸟宁波保税1号仓,354,0,354,0,0,0,0,0,0,0,0,0,0,0,354,0,354,0,0,0,0,0,0,0,0,0,0,0,0,0,0,0
2018-04-12,521786983343,XY521068155265,Graceland Fruit 整粒蔓越莓果干 1000克,菜鸟上海保税1号仓,84,84,0,0,0,0,0,0,2,2,0,0,0,0,82,82,0,0,0,0,0,0,0,0,0,0,0,0,0,0,0,0
2018-04-12,521795141212,XY521078390258,Graceland Fruit 整粒蔓越莓果干 226.8克,菜鸟上海保税1号仓,11472,0,11472,0,0,0,0,0,0,0,0,0,0,0,11472,0,11472,0,0,0,0,0,0,0,0,0,0,0,0,0,0,0
2018-04-12,521798656939,XY521074725008,Graceland Fruit 蔓越莓切片果干 1000克,菜鸟上海保税1号仓,200,200,0,0,0,0,0,0,2,2,0,0,0,0,198,198,0,0,0,0,0,0,0,0,0,0,0,0,0,0,0,0
2018-04-12,521798716403,XY521077912497,Graceland Fruit 蓝莓果干 1000克,菜鸟上海保税1号仓,81,81,0,0,0,0,0,0,2,2,0,0,0,0,79,79,0,0,0,0,0,0,0,0,0,0,0,0,0,0,0,0
2018-04-12,521799186703,XY521073901132,Graceland Fruit 蓝莓果干 141.7克,菜鸟上海保税1号仓,4303,0,4303,0,0,0,0,0,0,0,0,0,0,0,4303,0,4303,0,0,0,0,0,0,0,0,0,0,0,0,0,0,0
2018-04-12,521799426484,XY521074249153,Graceland Fruit 酸樱桃果干 1000克,菜鸟上海保税1号仓,124,124,0,0,0,0,0,0,2,2,0,0,0,0,122,122,0,0,0,0,0,0,0,0,0,0,0,0,0,0,0,0
2018-04-12,542151364809,708390000210,GracelandFruit莓果橙皮 混合果干 454克,菜鸟上海保税1号仓,51,51,0,0,0,0,0,0,0,0,0,0,0,0,51,51,0,0,0,0,0,0,0,0,0,0,0,0,0,0,0,0
2018-04-12,542151596151,708390000227,GracelandFruit芒果莓果 混合果干 454克,菜鸟上海保税1号仓,26,26,0,0,0,0,0,0,1,1,0,0,0,0,25,25,0,0,0,0,0,0,0,0,0,0,0,0,0,0,0,0
2018-04-12,562082510339,8802534778019,Graceland Fruit整粒蔓越莓黑巧克力,菜鸟上海保税1号仓,2170,2170,0,0,0,0,0,0,0,0,0,0,0,0,2170,2170,0,0,0,0,0,0,0,0,0,0,0,0,0,0,0,0
2018-04-12,562106910483,8802534778002,Graceland Fruit蓝莓黑巧克力,菜鸟上海保税1号仓,2107,2107,0,0,0,0,0,0,2,2,0,0,0,0,2105,2105,0,0,0,0,0,0,0,0,0,0,0,0,0,0,0,0
2018-04-12,521783799351,XY521067771349,Graceland Fruit 整粒蔓越莓果干 40克,菜鸟宁波保税1号仓,6,0,6,0,0,0,0,0,0,0,0,0,0,0,6,0,6,0,0,0,0,0,0,0,0,0,0,0,0,0,0,0
2018-04-12,521795141212,XY521078390258,Graceland Fruit 整粒蔓越莓果干 226.8克,菜鸟宁波保税1号仓,1,0,1,0,0,0,0,0,0,0,0,0,0,0,1,0,1,0,0,0,0,0,0,0,0,0,0,0,0,0,0,0
2018-04-12,521799186703,XY521073901132,Graceland Fruit 蓝莓果干 141.7克,菜鸟宁波保税1号仓,3,3,0,0,0,0,0,0,0,0,0,0,0,0,3,3,0,0,0,0,0,0,0,0,0,0,0,0,0,0,0,0
2018-04-12,542151364809,708390000210,GracelandFruit莓果橙皮 混合果干 454克,菜鸟宁波保税1号仓,278,0,278,0,0,0,0,0,0,0,0,0,0,0,278,0,278,0,0,0,0,0,0,0,0,0,0,0,0,0,0,0
2018-04-12,542151596151,708390000227,GracelandFruit芒果莓果 混合果干 454克,菜鸟宁波保税1号仓,1,0,1,0,0,0,0,0,0,0,0,0,0,0,1,0,1,0,0,0,0,0,0,0,0,0,0,0,0,0,0,0
2018-04-12,542176430821,708390000203,GracelandFruit全美苹果 混合果干 454克,菜鸟宁波保税1号仓,354,0,354,0,0,0,0,0,0,0,0,0,0,0,354,0,354,0,0,0,0,0,0,0,0,0,0,0,0,0,0,0
2018-04-11,521786983343,XY521068155265,Graceland Fruit 整粒蔓越莓果干 1000克,菜鸟上海保税1号仓,88,88,0,0,0,0,0,0,4,4,0,0,0,0,84,84,0,0,0,0,0,0,0,0,0,0,0,0,0,0,0,0
2018-04-11,521795141212,XY521078390258,Graceland Fruit 整粒蔓越莓果干 226.8克,菜鸟上海保税1号仓,11472,0,11472,0,0,0,0,0,0,0,0,0,0,0,11472,0,11472,0,0,0,0,0,0,0,0,0,0,0,0,0,0,0
2018-04-11,521798656939,XY521074725008,Graceland Fruit 蔓越莓切片果干 1000克,菜鸟上海保税1号仓,201,201,0,0,0,0,0,0,1,1,0,0,0,0,200,200,0,0,0,0,0,0,0,0,0,0,0,0,0,0,0,0
2018-04-11,521798716403,XY521077912497,Graceland Fruit 蓝莓果干 1000克,菜鸟上海保税1号仓,83,83,0,0,0,0,0,0,2,2,0,0,0,0,81,81,0,0,0,0,0,0,0,0,0,0,0,0,0,0,0,0
2018-04-11,521799186703,XY521073901132,Graceland Fruit 蓝莓果干 141.7克,菜鸟上海保税1号仓,4303,0,4303,0,0,0,0,0,0,0,0,0,0,0,4303,0,4303,0,0,0,0,0,0,0,0,0,0,0,0,0,0,0
2018-04-11,521799426484,XY521074249153,Graceland Fruit 酸樱桃果干 1000克,菜鸟上海保税1号仓,124,124,0,0,0,0,0,0,0,0,0,0,0,0,124,124,0,0,0,0,0,0,0,0,0,0,0,0,0,0,0,0
2018-04-11,542151364809,708390000210,GracelandFruit莓果橙皮 混合果干 454克,菜鸟上海保税1号仓,51,51,0,0,0,0,0,0,0,0,0,0,0,0,51,51,0,0,0,0,0,0,0,0,0,0,0,0,0,0,0,0
2018-04-11,542151596151,708390000227,GracelandFruit芒果莓果 混合果干 454克,菜鸟上海保税1号仓,26,26,0,0,0,0,0,0,0,0,0,0,0,0,26,26,0,0,0,0,0,0,0,0,0,0,0,0,0,0,0,0
2018-04-11,562082510339,8802534778019,Graceland Fruit整粒蔓越莓黑巧克力,菜鸟上海保税1号仓,2170,2170,0,0,0,0,0,0,0,0,0,0,0,0,2170,2170,0,0,0,0,0,0,0,0,0,0,0,0,0,0,0,0
2018-04-11,562106910483,8802534778002,Graceland Fruit蓝莓黑巧克力,菜鸟上海保税1号仓,2107,2107,0,0,0,0,0,0,0,0,0,0,0,0,2107,2107,0,0,0,0,0,0,0,0,0,0,0,0,0,0,0,0
2018-04-11,521783799351,XY521067771349,Graceland Fruit 整粒蔓越莓果干 40克,菜鸟宁波保税1号仓,6,0,6,0,0,0,0,0,0,0,0,0,0,0,6,0,6,0,0,0,0,0,0,0,0,0,0,0,0,0,0,0
2018-04-11,521795141212,XY521078390258,Graceland Fruit 整粒蔓越莓果干 226.8克,菜鸟宁波保税1号仓,1,0,1,0,0,0,0,0,0,0,0,0,0,0,1,0,1,0,0,0,0,0,0,0,0,0,0,0,0,0,0,0
2018-04-11,521799186703,XY521073901132,Graceland Fruit 蓝莓果干 141.7克,菜鸟宁波保税1号仓,3,3,0,0,0,0,0,0,0,0,0,0,0,0,3,3,0,0,0,0,0,0,0,0,0,0,0,0,0,0,0,0
2018-04-11,542151364809,708390000210,GracelandFruit莓果橙皮 混合果干 454克,菜鸟宁波保税1号仓,278,0,278,0,0,0,0,0,0,0,0,0,0,0,278,0,278,0,0,0,0,0,0,0,0,0,0,0,0,0,0,0
2018-04-11,542151596151,708390000227,GracelandFruit芒果莓果 混合果干 454克,菜鸟宁波保税1号仓,1,0,1,0,0,0,0,0,0,0,0,0,0,0,1,0,1,0,0,0,0,0,0,0,0,0,0,0,0,0,0,0
2018-04-11,542176430821,708390000203,GracelandFruit全美苹果 混合果干 454克,菜鸟宁波保税1号仓,354,0,354,0,0,0,0,0,0,0,0,0,0,0,354,0,354,0,0,0,0,0,0,0,0,0,0,0,0,0,0,0
2018-04-10,521786983343,XY521068155265,Graceland Fruit 整粒蔓越莓果干 1000克,菜鸟上海保税1号仓,88,88,0,0,0,0,0,0,0,0,0,0,0,0,88,88,0,0,0,0,0,0,0,0,0,0,0,0,0,0,0,0
2018-04-10,521795141212,XY521078390258,Graceland Fruit 整粒蔓越莓果干 226.8克,菜鸟上海保税1号仓,11472,0,11472,0,0,0,0,0,0,0,0,0,0,0,11472,0,11472,0,0,0,0,0,0,0,0,0,0,0,0,0,0,0
2018-04-10,521798656939,XY521074725008,Graceland Fruit 蔓越莓切片果干 1000克,菜鸟上海保税1号仓,203,203,0,0,0,0,0,0,2,2,0,0,0,0,201,201,0,0,0,0,0,0,0,0,0,0,0,0,0,0,0,0
2018-04-10,521798716403,XY521077912497,Graceland Fruit 蓝莓果干 1000克,菜鸟上海保税1号仓,85,85,0,0,0,0,0,0,2,2,0,0,0,0,83,83,0,0,0,0,0,0,0,0,0,0,0,0,0,0,0,0
2018-04-10,521799186703,XY521073901132,Graceland Fruit 蓝莓果干 141.7克,菜鸟上海保税1号仓,4303,0,4303,0,0,0,0,0,0,0,0,0,0,0,4303,0,4303,0,0,0,0,0,0,0,0,0,0,0,0,0,0,0
2018-04-10,521799426484,XY521074249153,Graceland Fruit 酸樱桃果干 1000克,菜鸟上海保税1号仓,124,124,0,0,0,0,0,0,0,0,0,0,0,0,124,124,0,0,0,0,0,0,0,0,0,0,0,0,0,0,0,0
2018-04-10,542151364809,708390000210,GracelandFruit莓果橙皮 混合果干 454克,菜鸟上海保税1号仓,51,51,0,0,0,0,0,0,0,0,0,0,0,0,51,51,0,0,0,0,0,0,0,0,0,0,0,0,0,0,0,0
2018-04-10,542151596151,708390000227,GracelandFruit芒果莓果 混合果干 454克,菜鸟上海保税1号仓,27,27,0,0,0,0,0,0,1,1,0,0,0,0,26,26,0,0,0,0,0,0,0,0,0,0,0,0,0,0,0,0
2018-04-10,562082510339,8802534778019,Graceland Fruit整粒蔓越莓黑巧克力,菜鸟上海保税1号仓,2170,2170,0,0,0,0,0,0,0,0,0,0,0,0,2170,2170,0,0,0,0,0,0,0,0,0,0,0,0,0,0,0,0
2018-04-10,562106910483,8802534778002,Graceland Fruit蓝莓黑巧克力,菜鸟上海保税1号仓,2107,2107,0,0,0,0,0,0,0,0,0,0,0,0,2107,2107,0,0,0,0,0,0,0,0,0,0,0,0,0,0,0,0
2018-04-10,521783799351,XY521067771349,Graceland Fruit 整粒蔓越莓果干 40克,菜鸟宁波保税1号仓,6,0,6,0,0,0,0,0,0,0,0,0,0,0,6,0,6,0,0,0,0,0,0,0,0,0,0,0,0,0,0,0
2018-04-10,521795141212,XY521078390258,Graceland Fruit 整粒蔓越莓果干 226.8克,菜鸟宁波保税1号仓,1,0,1,0,0,0,0,0,0,0,0,0,0,0,1,0,1,0,0,0,0,0,0,0,0,0,0,0,0,0,0,0
2018-04-10,521799186703,XY521073901132,Graceland Fruit 蓝莓果干 141.7克,菜鸟宁波保税1号仓,3,3,0,0,0,0,0,0,0,0,0,0,0,0,3,3,0,0,0,0,0,0,0,0,0,0,0,0,0,0,0,0
2018-04-10,542151364809,708390000210,GracelandFruit莓果橙皮 混合果干 454克,菜鸟宁波保税1号仓,278,0,278,0,0,0,0,0,0,0,0,0,0,0,278,0,278,0,0,0,0,0,0,0,0,0,0,0,0,0,0,0
2018-04-10,542151596151,708390000227,GracelandFruit芒果莓果 混合果干 454克,菜鸟宁波保税1号仓,1,0,1,0,0,0,0,0,0,0,0,0,0,0,1,0,1,0,0,0,0,0,0,0,0,0,0,0,0,0,0,0
2018-04-10,542176430821,708390000203,GracelandFruit全美苹果 混合果干 454克,菜鸟宁波保税1号仓,354,0,354,0,0,0,0,0,0,0,0,0,0,0,354,0,354,0,0,0,0,0,0,0,0,0,0,0,0,0,0,0
2018-04-09,521786983343,XY521068155265,Graceland Fruit 整粒蔓越莓果干 1000克,菜鸟上海保税1号仓,89,89,0,0,0,0,0,0,1,1,0,0,0,0,88,88,0,0,0,0,0,0,0,0,0,0,0,0,0,0,0,0
2018-04-09,521795141212,XY521078390258,Graceland Fruit 整粒蔓越莓果干 226.8克,菜鸟上海保税1号仓,11472,0,11472,0,0,0,0,0,0,0,0,0,0,0,11472,0,11472,0,0,0,0,0,0,0,0,0,0,0,0,0,0,0
2018-04-09,521798656939,XY521074725008,Graceland Fruit 蔓越莓切片果干 1000克,菜鸟上海保税1号仓,203,203,0,0,0,0,0,0,0,0,0,0,0,0,203,203,0,0,0,0,0,0,0,0,0,0,0,0,0,0,0,0
2018-04-09,521798716403,XY521077912497,Graceland Fruit 蓝莓果干 1000克,菜鸟上海保税1号仓,86,86,0,0,0,0,0,0,1,1,0,0,0,0,85,85,0,0,0,0,0,0,0,0,0,0,0,0,0,0,0,0
2018-04-09,521799186703,XY521073901132,Graceland Fruit 蓝莓果干 141.7克,菜鸟上海保税1号仓,4303,0,4303,0,0,0,0,0,0,0,0,0,0,0,4303,0,4303,0,0,0,0,0,0,0,0,0,0,0,0,0,0,0
2018-04-09,521799426484,XY521074249153,Graceland Fruit 酸樱桃果干 1000克,菜鸟上海保税1号仓,124,124,0,0,0,0,0,0,0,0,0,0,0,0,124,124,0,0,0,0,0,0,0,0,0,0,0,0,0,0,0,0
2018-04-09,542151364809,708390000210,GracelandFruit莓果橙皮 混合果干 454克,菜鸟上海保税1号仓,51,51,0,0,0,0,0,0,0,0,0,0,0,0,51,51,0,0,0,0,0,0,0,0,0,0,0,0,0,0,0,0
2018-04-09,542151596151,708390000227,GracelandFruit芒果莓果 混合果干 454克,菜鸟上海保税1号仓,27,27,0,0,0,0,0,0,0,0,0,0,0,0,27,27,0,0,0,0,0,0,0,0,0,0,0,0,0,0,0,0
2018-04-09,562082510339,8802534778019,Graceland Fruit整粒蔓越莓黑巧克力,菜鸟上海保税1号仓,2170,2170,0,0,0,0,0,0,0,0,0,0,0,0,2170,2170,0,0,0,0,0,0,0,0,0,0,0,0,0,0,0,0
2018-04-09,562106910483,8802534778002,Graceland Fruit蓝莓黑巧克力,菜鸟上海保税1号仓,2107,2107,0,0,0,0,0,0,0,0,0,0,0,0,2107,2107,0,0,0,0,0,0,0,0,0,0,0,0,0,0,0,0
2018-04-09,521783799351,XY521067771349,Graceland Fruit 整粒蔓越莓果干 40克,菜鸟宁波保税1号仓,6,0,6,0,0,0,0,0,0,0,0,0,0,0,6,0,6,0,0,0,0,0,0,0,0,0,0,0,0,0,0,0
2018-04-09,521795141212,XY521078390258,Graceland Fruit 整粒蔓越莓果干 226.8克,菜鸟宁波保税1号仓,1,0,1,0,0,0,0,0,0,0,0,0,0,0,1,0,1,0,0,0,0,0,0,0,0,0,0,0,0,0,0,0
2018-04-09,521799186703,XY521073901132,Graceland Fruit 蓝莓果干 141.7克,菜鸟宁波保税1号仓,3,3,0,0,0,0,0,0,0,0,0,0,0,0,3,3,0,0,0,0,0,0,0,0,0,0,0,0,0,0,0,0
2018-04-09,542151364809,708390000210,GracelandFruit莓果橙皮 混合果干 454克,菜鸟宁波保税1号仓,278,0,278,0,0,0,0,0,0,0,0,0,0,0,278,0,278,0,0,0,0,0,0,0,0,0,0,0,0,0,0,0
2018-04-09,542151596151,708390000227,GracelandFruit芒果莓果 混合果干 454克,菜鸟宁波保税1号仓,1,0,1,0,0,0,0,0,0,0,0,0,0,0,1,0,1,0,0,0,0,0,0,0,0,0,0,0,0,0,0,0
2018-04-09,542176430821,708390000203,GracelandFruit全美苹果 混合果干 454克,菜鸟宁波保税1号仓,354,0,354,0,0,0,0,0,0,0,0,0,0,0,354,0,354,0,0,0,0,0,0,0,0,0,0,0,0,0,0,0
2018-04-08,521786983343,XY521068155265,Graceland Fruit 整粒蔓越莓果干 1000克,菜鸟上海保税1号仓,92,92,0,0,0,0,0,0,3,3,0,0,0,0,89,89,0,0,0,0,0,0,0,0,0,0,0,0,0,0,0,0
2018-04-08,521795141212,XY521078390258,Graceland Fruit 整粒蔓越莓果干 226.8克,菜鸟上海保税1号仓,11472,0,11472,0,0,0,0,0,0,0,0,0,0,0,11472,0,11472,0,0,0,0,0,0,0,0,0,0,0,0,0,0,0
2018-04-08,521798656939,XY521074725008,Graceland Fruit 蔓越莓切片果干 1000克,菜鸟上海保税1号仓,204,204,0,0,0,0,0,0,1,1,0,0,0,0,203,203,0,0,0,0,0,0,0,0,0,0,0,0,0,0,0,0
2018-04-08,521798716403,XY521077912497,Graceland Fruit 蓝莓果干 1000克,菜鸟上海保税1号仓,90,90,0,0,0,0,0,0,4,4,0,0,0,0,86,86,0,0,0,0,0,0,0,0,0,0,0,0,0,0,0,0
2018-04-08,521799186703,XY521073901132,Graceland Fruit 蓝莓果干 141.7克,菜鸟上海保税1号仓,4303,0,4303,0,0,0,0,0,0,0,0,0,0,0,4303,0,4303,0,0,0,0,0,0,0,0,0,0,0,0,0,0,0
2018-04-08,521799426484,XY521074249153,Graceland Fruit 酸樱桃果干 1000克,菜鸟上海保税1号仓,124,124,0,0,0,0,0,0,0,0,0,0,0,0,124,124,0,0,0,0,0,0,0,0,0,0,0,0,0,0,0,0
2018-04-08,542151364809,708390000210,GracelandFruit莓果橙皮 混合果干 454克,菜鸟上海保税1号仓,52,52,0,0,0,0,0,0,1,1,0,0,0,0,51,51,0,0,0,0,0,0,0,0,0,0,0,0,0,0,0,0
2018-04-08,542151596151,708390000227,GracelandFruit芒果莓果 混合果干 454克,菜鸟上海保税1号仓,27,27,0,0,0,0,0,0,0,0,0,0,0,0,27,27,0,0,0,0,0,0,0,0,0,0,0,0,0,0,0,0
2018-04-08,562082510339,8802534778019,Graceland Fruit整粒蔓越莓黑巧克力,菜鸟上海保税1号仓,2170,2170,0,0,0,0,0,0,0,0,0,0,0,0,2170,2170,0,0,0,0,0,0,0,0,0,0,0,0,0,0,0,0
2018-04-08,562106910483,8802534778002,Graceland Fruit蓝莓黑巧克力,菜鸟上海保税1号仓,2107,2107,0,0,0,0,0,0,0,0,0,0,0,0,2107,2107,0,0,0,0,0,0,0,0,0,0,0,0,0,0,0,0
2018-04-08,521783799351,XY521067771349,Graceland Fruit 整粒蔓越莓果干 40克,菜鸟宁波保税1号仓,6,0,6,0,0,0,0,0,0,0,0,0,0,0,6,0,6,0,0,0,0,0,0,0,0,0,0,0,0,0,0,0
2018-04-08,521795141212,XY521078390258,Graceland Fruit 整粒蔓越莓果干 226.8克,菜鸟宁波保税1号仓,1,0,1,0,0,0,0,0,0,0,0,0,0,0,1,0,1,0,0,0,0,0,0,0,0,0,0,0,0,0,0,0
2018-04-08,521799186703,XY521073901132,Graceland Fruit 蓝莓果干 141.7克,菜鸟宁波保税1号仓,3,3,0,0,0,0,0,0,0,0,0,0,0,0,3,3,0,0,0,0,0,0,0,0,0,0,0,0,0,0,0,0
2018-04-08,542151364809,708390000210,GracelandFruit莓果橙皮 混合果干 454克,菜鸟宁波保税1号仓,278,0,278,0,0,0,0,0,0,0,0,0,0,0,278,0,278,0,0,0,0,0,0,0,0,0,0,0,0,0,0,0
2018-04-08,542151596151,708390000227,GracelandFruit芒果莓果 混合果干 454克,菜鸟宁波保税1号仓,1,0,1,0,0,0,0,0,0,0,0,0,0,0,1,0,1,0,0,0,0,0,0,0,0,0,0,0,0,0,0,0
2018-04-08,542176430821,708390000203,GracelandFruit全美苹果 混合果干 454克,菜鸟宁波保税1号仓,354,0,354,0,0,0,0,0,0,0,0,0,0,0,354,0,354,0,0,0,0,0,0,0,0,0,0,0,0,0,0,0
2018-04-07,521786983343,XY521068155265,Graceland Fruit 整粒蔓越莓果干 1000克,菜鸟上海保税1号仓,94,94,0,0,0,0,0,0,2,2,0,0,0,0,92,92,0,0,0,0,0,0,0,0,0,0,0,0,0,0,0,0
2018-04-07,521795141212,XY521078390258,Graceland Fruit 整粒蔓越莓果干 226.8克,菜鸟上海保税1号仓,11472,0,11472,0,0,0,0,0,0,0,0,0,0,0,11472,0,11472,0,0,0,0,0,0,0,0,0,0,0,0,0,0,0
2018-04-07,521798656939,XY521074725008,Graceland Fruit 蔓越莓切片果干 1000克,菜鸟上海保税1号仓,205,205,0,0,0,0,0,0,1,1,0,0,0,0,204,204,0,0,0,0,0,0,0,0,0,0,0,0,0,0,0,0
2018-04-07,521798716403,XY521077912497,Graceland Fruit 蓝莓果干 1000克,菜鸟上海保税1号仓,92,92,0,0,0,0,0,0,2,2,0,0,0,0,90,90,0,0,0,0,0,0,0,0,0,0,0,0,0,0,0,0
2018-04-07,521799186703,XY521073901132,Graceland Fruit 蓝莓果干 141.7克,菜鸟上海保税1号仓,4303,0,4303,0,0,0,0,0,0,0,0,0,0,0,4303,0,4303,0,0,0,0,0,0,0,0,0,0,0,0,0,0,0
2018-04-07,521799426484,XY521074249153,Graceland Fruit 酸樱桃果干 1000克,菜鸟上海保税1号仓,125,125,0,0,0,0,0,0,1,1,0,0,0,0,124,124,0,0,0,0,0,0,0,0,0,0,0,0,0,0,0,0
2018-04-07,542151364809,708390000210,GracelandFruit莓果橙皮 混合果干 454克,菜鸟上海保税1号仓,52,52,0,0,0,0,0,0,0,0,0,0,0,0,52,52,0,0,0,0,0,0,0,0,0,0,0,0,0,0,0,0
2018-04-07,542151596151,708390000227,GracelandFruit芒果莓果 混合果干 454克,菜鸟上海保税1号仓,27,27,0,0,0,0,0,0,0,0,0,0,0,0,27,27,0,0,0,0,0,0,0,0,0,0,0,0,0,0,0,0
2018-04-07,562082510339,8802534778019,Graceland Fruit整粒蔓越莓黑巧克力,菜鸟上海保税1号仓,2171,2171,0,0,0,0,0,0,1,1,0,0,0,0,2170,2170,0,0,0,0,0,0,0,0,0,0,0,0,0,0,0,0
2018-04-07,562106910483,8802534778002,Graceland Fruit蓝莓黑巧克力,菜鸟上海保税1号仓,2108,2108,0,0,0,0,0,0,1,1,0,0,0,0,2107,2107,0,0,0,0,0,0,0,0,0,0,0,0,0,0,0,0
2018-04-07,521783799351,XY521067771349,Graceland Fruit 整粒蔓越莓果干 40克,菜鸟宁波保税1号仓,6,0,6,0,0,0,0,0,0,0,0,0,0,0,6,0,6,0,0,0,0,0,0,0,0,0,0,0,0,0,0,0
2018-04-07,521795141212,XY521078390258,Graceland Fruit 整粒蔓越莓果干 226.8克,菜鸟宁波保税1号仓,1,0,1,0,0,0,0,0,0,0,0,0,0,0,1,0,1,0,0,0,0,0,0,0,0,0,0,0,0,0,0,0
2018-04-07,521799186703,XY521073901132,Graceland Fruit 蓝莓果干 141.7克,菜鸟宁波保税1号仓,3,3,0,0,0,0,0,0,0,0,0,0,0,0,3,3,0,0,0,0,0,0,0,0,0,0,0,0,0,0,0,0
2018-04-07,542151364809,708390000210,GracelandFruit莓果橙皮 混合果干 454克,菜鸟宁波保税1号仓,278,0,278,0,0,0,0,0,0,0,0,0,0,0,278,0,278,0,0,0,0,0,0,0,0,0,0,0,0,0,0,0
2018-04-07,542151596151,708390000227,GracelandFruit芒果莓果 混合果干 454克,菜鸟宁波保税1号仓,1,0,1,0,0,0,0,0,0,0,0,0,0,0,1,0,1,0,0,0,0,0,0,0,0,0,0,0,0,0,0,0
2018-04-07,542176430821,708390000203,GracelandFruit全美苹果 混合果干 454克,菜鸟宁波保税1号仓,354,0,354,0,0,0,0,0,0,0,0,0,0,0,354,0,354,0,0,0,0,0,0,0,0,0,0,0,0,0,0,0
2018-04-06,521786983343,XY521068155265,Graceland Fruit 整粒蔓越莓果干 1000克,菜鸟上海保税1号仓,100,100,0,0,0,0,0,0,6,6,0,0,0,0,94,94,0,0,0,0,0,0,0,0,0,0,0,0,0,0,0,0
2018-04-06,521795141212,XY521078390258,Graceland Fruit 整粒蔓越莓果干 226.8克,菜鸟上海保税1号仓,11472,0,11472,0,0,0,0,0,0,0,0,0,0,0,11472,0,11472,0,0,0,0,0,0,0,0,0,0,0,0,0,0,0
2018-04-06,521798656939,XY521074725008,Graceland Fruit 蔓越莓切片果干 1000克,菜鸟上海保税1号仓,205,205,0,0,0,0,0,0,0,0,0,0,0,0,205,205,0,0,0,0,0,0,0,0,0,0,0,0,0,0,0,0
2018-04-06,521798716403,XY521077912497,Graceland Fruit 蓝莓果干 1000克,菜鸟上海保税1号仓,94,94,0,0,0,0,0,0,2,2,0,0,0,0,92,92,0,0,0,0,0,0,0,0,0,0,0,0,0,0,0,0
2018-04-06,521799186703,XY521073901132,Graceland Fruit 蓝莓果干 141.7克,菜鸟上海保税1号仓,4303,0,4303,0,0,0,0,0,0,0,0,0,0,0,4303,0,4303,0,0,0,0,0,0,0,0,0,0,0,0,0,0,0
2018-04-06,521799426484,XY521074249153,Graceland Fruit 酸樱桃果干 1000克,菜鸟上海保税1号仓,125,125,0,0,0,0,0,0,0,0,0,0,0,0,125,125,0,0,0,0,0,0,0,0,0,0,0,0,0,0,0,0
2018-04-06,542151364809,708390000210,GracelandFruit莓果橙皮 混合果干 454克,菜鸟上海保税1号仓,54,54,0,0,0,0,0,0,2,2,0,0,0,0,52,52,0,0,0,0,0,0,0,0,0,0,0,0,0,0,0,0
2018-04-06,542151596151,708390000227,GracelandFruit芒果莓果 混合果干 454克,菜鸟上海保税1号仓,28,28,0,0,0,0,0,0,1,1,0,0,0,0,27,27,0,0,0,0,0,0,0,0,0,0,0,0,0,0,0,0
2018-04-06,562082510339,8802534778019,Graceland Fruit整粒蔓越莓黑巧克力,菜鸟上海保税1号仓,2171,2171,0,0,0,0,0,0,0,0,0,0,0,0,2171,2171,0,0,0,0,0,0,0,0,0,0,0,0,0,0,0,0
2018-04-06,562106910483,8802534778002,Graceland Fruit蓝莓黑巧克力,菜鸟上海保税1号仓,2108,2108,0,0,0,0,0,0,0,0,0,0,0,0,2108,2108,0,0,0,0,0,0,0,0,0,0,0,0,0,0,0,0
2018-04-06,521783799351,XY521067771349,Graceland Fruit 整粒蔓越莓果干 40克,菜鸟宁波保税1号仓,6,0,6,0,0,0,0,0,0,0,0,0,0,0,6,0,6,0,0,0,0,0,0,0,0,0,0,0,0,0,0,0
2018-04-06,521795141212,XY521078390258,Graceland Fruit 整粒蔓越莓果干 226.8克,菜鸟宁波保税1号仓,1,0,1,0,0,0,0,0,0,0,0,0,0,0,1,0,1,0,0,0,0,0,0,0,0,0,0,0,0,0,0,0
2018-04-06,521799186703,XY521073901132,Graceland Fruit 蓝莓果干 141.7克,菜鸟宁波保税1号仓,3,3,0,0,0,0,0,0,0,0,0,0,0,0,3,3,0,0,0,0,0,0,0,0,0,0,0,0,0,0,0,0
2018-04-06,542151364809,708390000210,GracelandFruit莓果橙皮 混合果干 454克,菜鸟宁波保税1号仓,278,0,278,0,0,0,0,0,0,0,0,0,0,0,278,0,278,0,0,0,0,0,0,0,0,0,0,0,0,0,0,0
2018-04-06,542151596151,708390000227,GracelandFruit芒果莓果 混合果干 454克,菜鸟宁波保税1号仓,1,0,1,0,0,0,0,0,0,0,0,0,0,0,1,0,1,0,0,0,0,0,0,0,0,0,0,0,0,0,0,0
2018-04-06,542176430821,708390000203,GracelandFruit全美苹果 混合果干 454克,菜鸟宁波保税1号仓,354,0,354,0,0,0,0,0,0,0,0,0,0,0,354,0,354,0,0,0,0,0,0,0,0,0,0,0,0,0,0,0
2018-04-05,521786983343,XY521068155265,Graceland Fruit 整粒蔓越莓果干 1000克,菜鸟上海保税1号仓,100,100,0,0,0,0,0,0,0,0,0,0,0,0,100,100,0,0,0,0,0,0,0,0,0,0,0,0,0,0,0,0
2018-04-05,521795141212,XY521078390258,Graceland Fruit 整粒蔓越莓果干 226.8克,菜鸟上海保税1号仓,11472,0,11472,0,0,0,0,0,0,0,0,0,0,0,11472,0,11472,0,0,0,0,0,0,0,0,0,0,0,0,0,0,0
2018-04-05,521798656939,XY521074725008,Graceland Fruit 蔓越莓切片果干 1000克,菜鸟上海保税1号仓,207,207,0,0,0,0,0,0,2,2,0,0,0,0,205,205,0,0,0,0,0,0,0,0,0,0,0,0,0,0,0,0
2018-04-05,521798716403,XY521077912497,Graceland Fruit 蓝莓果干 1000克,菜鸟上海保税1号仓,97,97,0,0,0,0,0,0,3,3,0,0,0,0,94,94,0,0,0,0,0,0,0,0,0,0,0,0,0,0,0,0
2018-04-05,521799186703,XY521073901132,Graceland Fruit 蓝莓果干 141.7克,菜鸟上海保税1号仓,4303,0,4303,0,0,0,0,0,0,0,0,0,0,0,4303,0,4303,0,0,0,0,0,0,0,0,0,0,0,0,0,0,0
2018-04-05,521799426484,XY521074249153,Graceland Fruit 酸樱桃果干 1000克,菜鸟上海保税1号仓,126,126,0,0,0,0,0,0,1,1,0,0,0,0,125,125,0,0,0,0,0,0,0,0,0,0,0,0,0,0,0,0
2018-04-05,542151364809,708390000210,GracelandFruit莓果橙皮 混合果干 454克,菜鸟上海保税1号仓,54,54,0,0,0,0,0,0,0,0,0,0,0,0,54,54,0,0,0,0,0,0,0,0,0,0,0,0,0,0,0,0
2018-04-05,542151596151,708390000227,GracelandFruit芒果莓果 混合果干 454克,菜鸟上海保税1号仓,29,29,0,0,0,0,0,0,1,1,0,0,0,0,28,28,0,0,0,0,0,0,0,0,0,0,0,0,0,0,0,0
2018-04-05,562082510339,8802534778019,Graceland Fruit整粒蔓越莓黑巧克力,菜鸟上海保税1号仓,2171,2171,0,0,0,0,0,0,0,0,0,0,0,0,2171,2171,0,0,0,0,0,0,0,0,0,0,0,0,0,0,0,0
2018-04-05,562106910483,8802534778002,Graceland Fruit蓝莓黑巧克力,菜鸟上海保税1号仓,2108,2108,0,0,0,0,0,0,0,0,0,0,0,0,2108,2108,0,0,0,0,0,0,0,0,0,0,0,0,0,0,0,0
2018-04-05,521783799351,XY521067771349,Graceland Fruit 整粒蔓越莓果干 40克,菜鸟宁波保税1号仓,6,0,6,0,0,0,0,0,0,0,0,0,0,0,6,0,6,0,0,0,0,0,0,0,0,0,0,0,0,0,0,0
2018-04-05,521795141212,XY521078390258,Graceland Fruit 整粒蔓越莓果干 226.8克,菜鸟宁波保税1号仓,1,0,1,0,0,0,0,0,0,0,0,0,0,0,1,0,1,0,0,0,0,0,0,0,0,0,0,0,0,0,0,0
2018-04-05,521799186703,XY521073901132,Graceland Fruit 蓝莓果干 141.7克,菜鸟宁波保税1号仓,3,3,0,0,0,0,0,0,0,0,0,0,0,0,3,3,0,0,0,0,0,0,0,0,0,0,0,0,0,0,0,0
2018-04-05,542151364809,708390000210,GracelandFruit莓果橙皮 混合果干 454克,菜鸟宁波保税1号仓,278,0,278,0,0,0,0,0,0,0,0,0,0,0,278,0,278,0,0,0,0,0,0,0,0,0,0,0,0,0,0,0
2018-04-05,542151596151,708390000227,GracelandFruit芒果莓果 混合果干 454克,菜鸟宁波保税1号仓,1,0,1,0,0,0,0,0,0,0,0,0,0,0,1,0,1,0,0,0,0,0,0,0,0,0,0,0,0,0,0,0
2018-04-05,542176430821,708390000203,GracelandFruit全美苹果 混合果干 454克,菜鸟宁波保税1号仓,354,0,354,0,0,0,0,0,0,0,0,0,0,0,354,0,354,0,0,0,0,0,0,0,0,0,0,0,0,0,0,0
2018-04-04,521786983343,XY521068155265,Graceland Fruit 整粒蔓越莓果干 1000克,菜鸟上海保税1号仓,0,0,0,100,100,0,0,0,0,0,0,0,0,0,100,100,0,0,0,0,0,0,0,0,0,0,0,0,0,0,0,0
2018-04-04,521795141212,XY521078390258,Graceland Fruit 整粒蔓越莓果干 226.8克,菜鸟上海保税1号仓,11472,0,11472,0,0,0,0,0,0,0,0,0,0,0,11472,0,11472,0,0,0,0,0,0,0,0,0,0,0,0,0,0,0
2018-04-04,521798656939,XY521074725008,Graceland Fruit 蔓越莓切片果干 1000克,菜鸟上海保税1号仓,211,211,0,0,0,0,0,0,4,4,0,0,0,0,207,207,0,0,0,0,0,0,0,0,0,0,0,0,0,0,0,0
2018-04-04,521798716403,XY521077912497,Graceland Fruit 蓝莓果干 1000克,菜鸟上海保税1号仓,98,98,0,0,0,0,0,0,1,1,0,0,0,0,97,97,0,0,0,0,0,0,0,0,0,0,0,0,0,0,0,0
2018-04-04,521799186703,XY521073901132,Graceland Fruit 蓝莓果干 141.7克,菜鸟上海保税1号仓,4303,0,4303,0,0,0,0,0,0,0,0,0,0,0,4303,0,4303,0,0,0,0,0,0,0,0,0,0,0,0,0,0,0
2018-04-04,521799426484,XY521074249153,Graceland Fruit 酸樱桃果干 1000克,菜鸟上海保税1号仓,128,128,0,0,0,0,0,0,2,2,0,0,0,0,126,126,0,0,0,0,0,0,0,0,0,0,0,0,0,0,0,0
2018-04-04,542151364809,708390000210,GracelandFruit莓果橙皮 混合果干 454克,菜鸟上海保税1号仓,54,54,0,0,0,0,0,0,0,0,0,0,0,0,54,54,0,0,0,0,0,0,0,0,0,0,0,0,0,0,0,0
2018-04-04,542151596151,708390000227,GracelandFruit芒果莓果 混合果干 454克,菜鸟上海保税1号仓,29,29,0,0,0,0,0,0,0,0,0,0,0,0,29,29,0,0,0,0,0,0,0,0,0,0,0,0,0,0,0,0
2018-04-04,562082510339,8802534778019,Graceland Fruit整粒蔓越莓黑巧克力,菜鸟上海保税1号仓,671,671,0,1500,1500,0,0,0,0,0,0,0,0,0,2171,2171,0,0,0,0,0,0,0,0,0,0,0,0,0,0,0,0
2018-04-04,562106910483,8802534778002,Graceland Fruit蓝莓黑巧克力,菜鸟上海保税1号仓,609,609,0,1500,1500,0,0,0,1,1,0,0,0,0,2108,2108,0,0,0,0,0,0,0,0,0,0,0,0,0,0,0,0
2018-04-04,521783799351,XY521067771349,Graceland Fruit 整粒蔓越莓果干 40克,菜鸟宁波保税1号仓,6,0,6,0,0,0,0,0,0,0,0,0,0,0,6,0,6,0,0,0,0,0,0,0,0,0,0,0,0,0,0,0
2018-04-04,521795141212,XY521078390258,Graceland Fruit 整粒蔓越莓果干 226.8克,菜鸟宁波保税1号仓,1,0,1,0,0,0,0,0,0,0,0,0,0,0,1,0,1,0,0,0,0,0,0,0,0,0,0,0,0,0,0,0
2018-04-04,521799186703,XY521073901132,Graceland Fruit 蓝莓果干 141.7克,菜鸟宁波保税1号仓,3,3,0,0,0,0,0,0,0,0,0,0,0,0,3,3,0,0,0,0,0,0,0,0,0,0,0,0,0,0,0,0
2018-04-04,542151364809,708390000210,GracelandFruit莓果橙皮 混合果干 454克,菜鸟宁波保税1号仓,278,0,278,0,0,0,0,0,0,0,0,0,0,0,278,0,278,0,0,0,0,0,0,0,0,0,0,0,0,0,0,0
2018-04-04,542151596151,708390000227,GracelandFruit芒果莓果 混合果干 454克,菜鸟宁波保税1号仓,1,0,1,0,0,0,0,0,0,0,0,0,0,0,1,0,1,0,0,0,0,0,0,0,0,0,0,0,0,0,0,0
2018-04-04,542176430821,708390000203,GracelandFruit全美苹果 混合果干 454克,菜鸟宁波保税1号仓,354,0,354,0,0,0,0,0,0,0,0,0,0,0,354,0,354,0,0,0,0,0,0,0,0,0,0,0,0,0,0,0
2018-04-03,521786983343,XY521068155265,Graceland Fruit 整粒蔓越莓果干 1000克,菜鸟上海保税1号仓,0,0,0,0,0,0,0,0,0,0,0,0,0,0,0,0,0,100,0,0,0,0,0,0,0,0,0,0,0,0,0,0
2018-04-03,521795141212,XY521078390258,Graceland Fruit 整粒蔓越莓果干 226.8克,菜鸟上海保税1号仓,11472,0,11472,0,0,0,0,0,0,0,0,0,0,0,11472,0,11472,0,0,0,0,0,0,0,0,0,0,0,0,0,0,0
2018-04-03,521798656939,XY521074725008,Graceland Fruit 蔓越莓切片果干 1000克,菜鸟上海保税1号仓,217,217,0,0,0,0,0,0,6,6,0,0,0,0,211,211,0,0,0,0,0,0,0,0,0,0,0,0,0,0,0,0
2018-04-03,521798716403,XY521077912497,Graceland Fruit 蓝莓果干 1000克,菜鸟上海保税1号仓,99,99,0,0,0,0,0,0,1,1,0,0,0,0,98,98,0,0,0,0,0,0,0,0,0,0,0,0,0,0,0,0
2018-04-03,521799186703,XY521073901132,Graceland Fruit 蓝莓果干 141.7克,菜鸟上海保税1号仓,4303,0,4303,0,0,0,0,0,0,0,0,0,0,0,4303,0,4303,0,0,0,0,0,0,0,0,0,0,0,0,0,0,0
2018-04-03,521799426484,XY521074249153,Graceland Fruit 酸樱桃果干 1000克,菜鸟上海保税1号仓,129,129,0,0,0,0,0,0,1,1,0,0,0,0,128,128,0,0,0,0,0,0,0,0,0,0,0,0,0,0,0,0
2018-04-03,542151364809,708390000210,GracelandFruit莓果橙皮 混合果干 454克,菜鸟上海保税1号仓,55,55,0,0,0,0,0,0,1,1,0,0,0,0,54,54,0,0,0,0,0,0,0,0,0,0,0,0,0,0,0,0
2018-04-03,542151596151,708390000227,GracelandFruit芒果莓果 混合果干 454克,菜鸟上海保税1号仓,29,29,0,0,0,0,0,0,0,0,0,0,0,0,29,29,0,0,0,0,0,0,0,0,0,0,0,0,0,0,0,0
2018-04-03,562082510339,8802534778019,Graceland Fruit整粒蔓越莓黑巧克力,菜鸟上海保税1号仓,671,671,0,0,0,0,0,0,0,0,0,0,0,0,671,671,0,1500,0,0,0,0,0,0,0,0,0,0,0,0,0,0
2018-04-03,562106910483,8802534778002,Graceland Fruit蓝莓黑巧克力,菜鸟上海保税1号仓,609,609,0,0,0,0,0,0,0,0,0,0,0,0,609,609,0,1500,0,0,0,0,0,0,0,0,0,0,0,0,0,0
2018-04-03,521783799351,XY521067771349,Graceland Fruit 整粒蔓越莓果干 40克,菜鸟宁波保税1号仓,6,0,6,0,0,0,0,0,0,0,0,0,0,0,6,0,6,0,0,0,0,0,0,0,0,0,0,0,0,0,0,0
2018-04-03,521795141212,XY521078390258,Graceland Fruit 整粒蔓越莓果干 226.8克,菜鸟宁波保税1号仓,1,0,1,0,0,0,0,0,0,0,0,0,0,0,1,0,1,0,0,0,0,0,0,0,0,0,0,0,0,0,0,0
2018-04-03,521799186703,XY521073901132,Graceland Fruit 蓝莓果干 141.7克,菜鸟宁波保税1号仓,3,3,0,0,0,0,0,0,0,0,0,0,0,0,3,3,0,0,0,0,0,0,0,0,0,0,0,0,0,0,0,0
2018-04-03,542151364809,708390000210,GracelandFruit莓果橙皮 混合果干 454克,菜鸟宁波保税1号仓,278,0,278,0,0,0,0,0,0,0,0,0,0,0,278,0,278,0,0,0,0,0,0,0,0,0,0,0,0,0,0,0
2018-04-03,542151596151,708390000227,GracelandFruit芒果莓果 混合果干 454克,菜鸟宁波保税1号仓,1,0,1,0,0,0,0,0,0,0,0,0,0,0,1,0,1,0,0,0,0,0,0,0,0,0,0,0,0,0,0,0
2018-04-03,542176430821,708390000203,GracelandFruit全美苹果 混合果干 454克,菜鸟宁波保税1号仓,354,0,354,0,0,0,0,0,0,0,0,0,0,0,354,0,354,0,0,0,0,0,0,0,0,0,0,0,0,0,0,0
2018-04-02,521795141212,XY521078390258,Graceland Fruit 整粒蔓越莓果干 226.8克,菜鸟上海保税1号仓,11472,0,11472,0,0,0,0,0,0,0,0,0,0,0,11472,0,11472,0,0,0,0,0,0,0,0,0,0,0,0,0,0,0
2018-04-02,521798656939,XY521074725008,Graceland Fruit 蔓越莓切片果干 1000克,菜鸟上海保税1号仓,227,227,0,0,0,0,0,0,10,10,0,0,0,0,217,217,0,0,0,0,0,0,0,0,0,0,0,0,0,0,0,0
2018-04-02,521798716403,XY521077912497,Graceland Fruit 蓝莓果干 1000克,菜鸟上海保税1号仓,100,100,0,0,0,0,0,0,1,1,0,0,0,0,99,99,0,0,0,0,0,0,0,0,0,0,0,0,0,0,0,0
2018-04-02,521799186703,XY521073901132,Graceland Fruit 蓝莓果干 141.7克,菜鸟上海保税1号仓,4303,0,4303,0,0,0,0,0,0,0,0,0,0,0,4303,0,4303,0,0,0,0,0,0,0,0,0,0,0,0,0,0,0
2018-04-02,521799426484,XY521074249153,Graceland Fruit 酸樱桃果干 1000克,菜鸟上海保税1号仓,129,129,0,0,0,0,0,0,0,0,0,0,0,0,129,129,0,0,0,0,0,0,0,0,0,0,0,0,0,0,0,0
2018-04-02,542151364809,708390000210,GracelandFruit莓果橙皮 混合果干 454克,菜鸟上海保税1号仓,55,55,0,0,0,0,0,0,0,0,0,0,0,0,55,55,0,0,0,0,0,0,0,0,0,0,0,0,0,0,0,0
2018-04-02,542151596151,708390000227,GracelandFruit芒果莓果 混合果干 454克,菜鸟上海保税1号仓,29,29,0,0,0,0,0,0,0,0,0,0,0,0,29,29,0,0,0,0,0,0,0,0,0,0,0,0,0,0,0,0
2018-04-02,562082510339,8802534778019,Graceland Fruit整粒蔓越莓黑巧克力,菜鸟上海保税1号仓,671,671,0,0,0,0,0,0,0,0,0,0,0,0,671,671,0,0,0,0,0,0,0,0,0,0,0,0,0,0,0,0
2018-04-02,562106910483,8802534778002,Graceland Fruit蓝莓黑巧克力,菜鸟上海保税1号仓,610,610,0,0,0,0,0,0,1,1,0,0,0,0,609,609,0,0,0,0,0,0,0,0,0,0,0,0,0,0,0,0
2018-04-02,521783799351,XY521067771349,Graceland Fruit 整粒蔓越莓果干 40克,菜鸟宁波保税1号仓,6,0,6,0,0,0,0,0,0,0,0,0,0,0,6,0,6,0,0,0,0,0,0,0,0,0,0,0,0,0,0,0
2018-04-02,521795141212,XY521078390258,Graceland Fruit 整粒蔓越莓果干 226.8克,菜鸟宁波保税1号仓,1,0,1,0,0,0,0,0,0,0,0,0,0,0,1,0,1,0,0,0,0,0,0,0,0,0,0,0,0,0,0,0
2018-04-02,521799186703,XY521073901132,Graceland Fruit 蓝莓果干 141.7克,菜鸟宁波保税1号仓,3,3,0,0,0,0,0,0,0,0,0,0,0,0,3,3,0,0,0,0,0,0,0,0,0,0,0,0,0,0,0,0
2018-04-02,542151364809,708390000210,GracelandFruit莓果橙皮 混合果干 454克,菜鸟宁波保税1号仓,278,0,278,0,0,0,0,0,0,0,0,0,0,0,278,0,278,0,0,0,0,0,0,0,0,0,0,0,0,0,0,0
2018-04-02,542151596151,708390000227,GracelandFruit芒果莓果 混合果干 454克,菜鸟宁波保税1号仓,1,0,1,0,0,0,0,0,0,0,0,0,0,0,1,0,1,0,0,0,0,0,0,0,0,0,0,0,0,0,0,0
2018-04-02,542176430821,708390000203,GracelandFruit全美苹果 混合果干 454克,菜鸟宁波保税1号仓,354,0,354,0,0,0,0,0,0,0,0,0,0,0,354,0,354,0,0,0,0,0,0,0,0,0,0,0,0,0,0,0
2018-04-01,521795141212,XY521078390258,Graceland Fruit 整粒蔓越莓果干 226.8克,菜鸟上海保税1号仓,11472,0,11472,0,0,0,0,0,0,0,0,0,0,0,11472,0,11472,0,0,0,0,0,0,0,0,0,0,0,0,0,0,0
2018-04-01,521798656939,XY521074725008,Graceland Fruit 蔓越莓切片果干 1000克,菜鸟上海保税1号仓,228,228,0,0,0,0,0,0,1,1,0,0,0,0,227,227,0,0,0,0,0,0,0,0,0,0,0,0,0,0,0,0
2018-04-01,521798716403,XY521077912497,Graceland Fruit 蓝莓果干 1000克,菜鸟上海保税1号仓,101,101,0,0,0,0,0,0,1,1,0,0,0,0,100,100,0,0,0,0,0,0,0,0,0,0,0,0,0,0,0,0
2018-04-01,521799186703,XY521073901132,Graceland Fruit 蓝莓果干 141.7克,菜鸟上海保税1号仓,4303,0,4303,0,0,0,0,0,0,0,0,0,0,0,4303,0,4303,0,0,0,0,0,0,0,0,0,0,0,0,0,0,0
2018-04-01,521799426484,XY521074249153,Graceland Fruit 酸樱桃果干 1000克,菜鸟上海保税1号仓,129,129,0,0,0,0,0,0,0,0,0,0,0,0,129,129,0,0,0,0,0,0,0,0,0,0,0,0,0,0,0,0
2018-04-01,542151364809,708390000210,GracelandFruit莓果橙皮 混合果干 454克,菜鸟上海保税1号仓,55,55,0,0,0,0,0,0,0,0,0,0,0,0,55,55,0,0,0,0,0,0,0,0,0,0,0,0,0,0,0,0
2018-04-01,542151596151,708390000227,GracelandFruit芒果莓果 混合果干 454克,菜鸟上海保税1号仓,29,29,0,0,0,0,0,0,0,0,0,0,0,0,29,29,0,0,0,0,0,0,0,0,0,0,0,0,0,0,0,0
2018-04-01,562082510339,8802534778019,Graceland Fruit整粒蔓越莓黑巧克力,菜鸟上海保税1号仓,672,672,0,0,0,0,0,0,1,1,0,0,0,0,671,671,0,0,0,0,0,0,0,0,0,0,0,0,0,0,0,0
2018-04-01,562106910483,8802534778002,Graceland Fruit蓝莓黑巧克力,菜鸟上海保税1号仓,612,612,0,0,0,0,0,0,2,2,0,0,0,0,610,610,0,0,0,0,0,0,0,0,0,0,0,0,0,0,0,0
2018-04-01,521783799351,XY521067771349,Graceland Fruit 整粒蔓越莓果干 40克,菜鸟宁波保税1号仓,6,0,6,0,0,0,0,0,0,0,0,0,0,0,6,0,6,0,0,0,0,0,0,0,0,0,0,0,0,0,0,0
2018-04-01,521795141212,XY521078390258,Graceland Fruit 整粒蔓越莓果干 226.8克,菜鸟宁波保税1号仓,1,0,1,0,0,0,0,0,0,0,0,0,0,0,1,0,1,0,0,0,0,0,0,0,0,0,0,0,0,0,0,0
2018-04-01,521799186703,XY521073901132,Graceland Fruit 蓝莓果干 141.7克,菜鸟宁波保税1号仓,3,3,0,0,0,0,0,0,0,0,0,0,0,0,3,3,0,0,0,0,0,0,0,0,0,0,0,0,0,0,0,0
2018-04-01,542151364809,708390000210,GracelandFruit莓果橙皮 混合果干 454克,菜鸟宁波保税1号仓,278,0,278,0,0,0,0,0,0,0,0,0,0,0,278,0,278,0,0,0,0,0,0,0,0,0,0,0,0,0,0,0
2018-04-01,542151596151,708390000227,GracelandFruit芒果莓果 混合果干 454克,菜鸟宁波保税1号仓,1,0,1,0,0,0,0,0,0,0,0,0,0,0,1,0,1,0,0,0,0,0,0,0,0,0,0,0,0,0,0,0
2018-04-01,542176430821,708390000203,GracelandFruit全美苹果 混合果干 454克,菜鸟宁波保税1号仓,354,0,354,0,0,0,0,0,0,0,0,0,0,0,354,0,354,0,0,0,0,0,0,0,0,0,0,0,0,0,0,0
